atherosclerosis: xơ vữa động mạch
anticompetitive: phản cạnh tranh
apprenticeships: học việc
associationists: những người theo chủ nghĩa
acknowledgments: sự nhìn nhận
administration: sự quản trị
accomplishment: thành quả
apocalypticism: thuyết khải huyền
accountability: trách nhiệm
afforestations: trồng rừng
accommodations: chỗ ở
administrator: người quản lý
advertisement: quảng cáo
appropriation: chiếm đoạt
authoritarian: độc tài
administrated: quản lý
announcement: sự thông báo
architecture: ngành kiến trúc
appreciative: đánh giá cao
articulation: sự khớp nối
appendicular: hình thấu kính
accommodate: cung cấp, chứa đựng
advertising: quảng cáo
anniversary: kỉ niệm
advancement: thăng tiến
attribution: sự biểu hiện, sự tượng trưng
aggravation: làm tăng thêm
assemblyman: người trong hội đồng
aquaculture: nuôi trồng thủy sản
accounting: kế toán
assessment: thẩm định, lượng định, đánh giá
acceptance: chấp thuận
assistance: hỗ trợ
attractive: hấp dẫn
appearance: xuất hiện
affordable: giá cả phải chăng
adaptation: sự thích nghi
ammunition: đạn dược
available: có sẵn
assistant: phụ tá
afternoon: buổi chiều
advantage: lợi thế
analytics: phân tích
allowance: trợ cấp
apartment: căn hộ, chung cư
anonymous: vô danh
accompany: đồng hành
although: mặc dù
approach: tiếp cận
actually: thực ra
anything: bất cứ điều gì
activity: hoạt động
addition: thêm vào
achieved: đã đạt được
accepted: chấp thuận
acquired: mua
another: khác
against: chống lại
already: đã sẵn sàng
ability: có khả năng
average: trung bình cộng
account: tài khoản
article: bài báo
achieve: đạt được
assumed: giả định
around: xung quanh
action: hành động
always: luôn luôn
amount: số tiền
appear: xuất hiện
advice: lời khuyên
author: tác giả
acting: diễn xuất
about: khoảng
after: sau đó
among: ở giữa
along: dọc theo
alone: một mình, cô đơn
adult: trưởng thành
apple: quả táo
angry: tức giận
admit: thừa nhận
actor: diễn viên
angel: thiên thần
aunt: cô
area: khu vực, địa điểm
auto: tự động
alow: ôi chao
and: và
age: tuổi tác
add: thêm vào
ask: hỏi
any: bất kì
as: như
at: tại
bidirectionally: hai chiều
blamelessnesses: vô tội vạ
bloodlessnesses: không có máu
breathabilities: thở
brotherlinesses: tình anh em
businesspersons: doanh nhân
bouleversement: đại lộ
bootlessnesses: không có ủng
brainstormings: động não
blanketflowers: hoa chăn
barometrically: đo khí áp
bastardization: sự khốn nạn
businesswoman: nữ doanh nhân
bacteriologic: vi khuẩn học
backstretches: duỗi lưng
backcountries: đất nước
beneficiation: người thụ hưởng
breakthrough: đột phá
biographical: tiểu sử
battleground: chiến trường
businesslike: kinh doanh
bloodthirsty: khát máu
brainwashing: tẩy não
brinkmanship: nghề nghiệp
boringnesses: sự nhàm chán
brightnesses: độ sáng
businessman: doanh nhân
blockbuster: bom tấn
bloodstream: dòng máu
backcountry: hậu phương
breadwinner: trụ cột gia đình
beneficence: tính hay làm phúc
background: lý lịch
beneficial: có lợi
biological: sinh học
basketball: bóng rổ
breathless: hết hơi
blackboard: tấm bảng đen
beginning: bắt đầu
beautiful: xinh đẹp
broadcast: phát sóng
breakfast: bữa ăn sáng
brilliant: xuất sắc
briefcase: vật đựng hồ sơ
backstage: hậu trường
billboard: bảng quảng cáo
business: kinh doanh
building: xây dựng
becoming: trở thành
breaking: phá vỡ
birthday: sinh nhật
bathroom: phòng tắm
baseball: quả bóng rổ
behavior: hành vi
between: giữa, khoảng cách
because: bởi vì
believe: tin tưởng
benefit: lợi ích
brought: mang lại, mang đến
billion: tỷ
balance: cân bằng
banking: tin cậy, ngân hàng
besides: ngoài ra
before: trước đây
better: tốt hơn
become: trở nên, trở thành
became: trở thành
behind: phía sau
budget: ngân sách
bridge: cây cầu
board: bảng
began: bắt đầu
built: xây dựng
basic: cơ bản
bring: mang
black: màu đen
blood: máu
back: trở lại
book: cuốn sách, đặt phòng
bill: hóa đơn
blue: màu xanh
best: tốt nhất
beer: bia
bird: con chim
boat: thuyền
busy: bận
but: nhưng
big: lớn
buy: mua
bad: tệ
box: hộp
bar: quán bar
bed: giường ngủ
bee: con ong
by: bởi
be: là
contemporaneous: cùng thời
conservationist: nhà bảo tồn
constructionist: nhà xây dựng
complementarity: sự bổ sung
capitalizations: viết hoa
characteristic: đặc tính
constitutional: theo hiến pháp
classification: phân loại
comprehensible: có thể hiểu được
congregational: hội đoàn
containerboard: thùng chứa
counterbalance: đối trọng
countermeasure: biện pháp đối phó
communication: giao tiếp
comprehensive: sự nhận thức
consideration: sự xem xét
complementary: bổ túc
consolidation: sự bền vững, sự kiên cố
certification: chứng nhận
contamination: ô nhiễm
confrontation: đối đầu
construction: xây dựng
considerable: đáng kể
contribution: sự đóng góp
compensation: đền bù
conservative: thận trọng
conventional: thông thường
conversation: cuộc hội thoại
constitution: tổ chức
continuation: tiếp tục
competition: Sự cạnh tranh
corporation: sự hợp tác
comfortable: sự thoải mái
considering: đang cân nhắc, xem xét
combination: sự kết hợp
consumption: tiêu dùng
communicate: giao tiếp
concentrate: tập trung
challenging: thử thách
certificate: chứng chỉ
countrywide: ngoại ô
commission: ủy ban
conference: hội nghị
commercial: thương mạii
considered: xem xét
commitment: lời cam kết
collection: bộ sưu tập
confidence: tự tin
connection: sự kết nối
consistent: thích hợp
concerning: liên quan
completion: hoàn thành 
conclusion: phần kết luận
community: cộng đồng
committee: ủy ban
corporate: đoàn thể
condition: tình trạng
concerned: lo âu 
certainly: chắc chắn
challenge: thử thách
character: tính cách
component: thành phần
confident: tự tin
connected: đã kết nối 
candidate: ứng cử viên
classroom: phòng học
children: trẻ em
continue: tiếp tục
complete: hoàn thành
chairman: chủ tịch
computer: máy tính
customer: khách hàng
contract: hợp đồng
critical: sự phê bình
consumer: khách hàng
consider: xem xét
capacity: sức chứa
campaign: chiến dịch
control: kiểm soát
company: công ty
certain: chắc chắn
contact: liên lạc, liên hệ
country: thành phố
current: hiện hành
central: trung tâm
council: hội đồng
college: trường đại học
complex: phức tạp
century: thế kỷ
change: thay đổi
common: chung
course: khóa học
create: tạo nên
coming: đang đến
choice: lựa chọn
credit: tín dụng
client: khách hàng
chance: cơ hội
charge: sạc điện, phí
could: có thể 
chief: lãnh tụ, trưởng
cause: nguyên nhân, nguyên do
class: lớp học
close: đóng
court: sân nhà, chỗ ở
clear: trong sáng, khoảng trống
child: đứa trẻ
carry: mang
cover: che đậy, bao phủ 
check: kiểm tra
coast: bờ biển
chain: chuỗi
clean: sạch sẽ, rõ ràng
catch: nắm lấy, bắt lấy
come: đến
cost: phí
case: trường hợp, tình huống, thực tế
city: thành phố
call: gọi
care: quan tâm
cash: tiền mặt 
card: thẻ
cook: nấu
calm: điềm tĩnh
can: có thể
car: xe ô tô
cut: cắt
cry: khóc
differentiation: sự khác biệt
dissatisfaction: không hài lòng, không bằng lòng
discontinuation: ngừng, gián đoạn
desertification: sa mạc hóa, ngày hạn hán
disadvantageous: bẩt lợi, làm thiệt hại, làm tổn thất
disproportional: không cân xứng
dissatisfactory: không đạt yêu cầu
departmentalize: phòng ban, bộ phận hóa
destructivities: sự phá hủy
deliriousnesses: sự say mê
demographically: nhân khẩu học
demystification: sự phá vỡ
discrimination: phân biệt đối xử
disappointment: thất vọng, nản lòng
discriminatory: phân biệt đối xử, sự nhận thức
disintegration: sự tan rã
deconstruction: giải cấu trúc
discouragement: chán nản, thất vọng
disinclination: không ưa, chán ghét
differentiable: có thể phân biệt, chức năng phân biệt
determination: sự quyết tâm, sự cương quyết
distinguished: phân biệt 
demonstration: trình diễn, thuyết minh 
differentiate: phân biệt
disappointing: thất vọng, không làm thỏa mãn
documentation: tài liệu
discretionary: tùy ý
disadvantaged: thiệt thòi
disinterested: vô tư
discontinuity: sự gián đoạn
decompression: giảm bớt sức ép
decomposition: phân hủy
discontinuous: không liên tục
dispassionate: không hài lòng
demonstrative: biểu tình
distribution: phân phối
depreciation: khấu hao
differential: khác biệt
disciplinary: kỷ luật
disadvantage: bất lợi
disagreement: bất đồng ý kiến
displacement: dịch chuyển, sự dời chỗ
dissatisfied: không hài lòng
discriminate: phân biệt
disseminated: phổ biến
demographics: nhân khẩu học
development: phát triển
description: sự miêu tả
demonstrate: chứng minh
distinction: phân biệt
destination: nơi đến
distinctive: khác biệt
distributor: nhà phân phối
destruction: sự phá hủy
declaration: tờ khai
disposition: bố trí
distinguish: phân biệt, đặc biệt
documentary: phim tài liệu
department: phòng ban
discussion: thảo luận
definition: định nghĩa
difficulty: khó khăn
difference: sự khác biệt
depression: phiền muộn
definitive: dứt khoát
decorative: trang trí
dictionary: từ điển
deficiency: sự thiếu hụt
different: khác nhau
dangerous: nguy hiểm
demanding: yêu cầu
directory: danh mục
dependent: phụ thuộc
detection: phát hiện
departure: khởi hành
designing: thiết kế
defendant: bị cáo
detective: thám tử
disappear: biến mất, không còn
director: giám đốc
decision: phán quyết
division: phân công
district: huyện, miền, khu vực
detailed: chi tiết, bày tỏ
directly: trực tiếp
domestic: quốc nội
delivery: vận chuyển
document: tài liệu
daughter: con gái
describe: diễn tả
discuss: bàn luận
disease: bệnh
despite: bất chấp, khinh rẻ
decided: quyết định
driving: điều khiển
display: trưng bày
drawing: sức lôi cuốn, hấp dẫn
deposit: đặt cọc
diamond: kim cương
defense: phòng thủ
divorce: ly hôn
demand: nhu cầu
doctor: bác sĩ
dinner: bữa tối
danger: nguy hiểm
detect: phát hiện
desert: sa mạc
decent: hợp lệ
dragon: con rồng 
decree: nghị định
donate: quyên góp, tặng
delete: xóa
daily: hàng ngày
dream: giấc mơ
depth: độ sâu
doubt: nghi ngờ
dance: nhảy
dress: trang phục
drill: máy khoan
debut: ra mắt
dairy: sản phẩm bơ sữa
depot: kho chứa
devil: ác quỷ
date: ngày
door: cửa sổ
drug: thuốc
desk: bàn 
deep: sâu
draw: vẽ tranh
duck: con vịt
damn: chỉ trích
day: ngày
dog: chó
electromagnetic: điện từ
electrodynamics: động điện học
exemplification: sự tôn vinh
excommunication: sa thải, sự khai trừ
ethnomusicology: dân tộc học
extracurricular: ngoại khóa
effectivenesses: hiệu quả
educationalists: các nhà giáo dục học
electrochemical: điện hóa
electrodeposits: đồ điện tử
expensivenesses: sự đắt tiền
electronically: điện tử 
electroforming: điện hóa
electrofishing: đánh bóng điện
electabilities: điện năng
emotionalizing: tạo cảm xúc
electivenesses: quyền lựa chọn
emotionalistic: tình cảm
embarrassments: sự bối rối, lúng túng
ecclesiologist: nhà giáo hội học
ecocatastrophe: thảm họa
environmental: thuộc về môi trường
entertainment: môi trường
extraordinary: lạ lùng, phi thường
establishment: thành lập
encouragement: sự khuyến khích 
embarrassment: sự lúng túng
electrostatic: tĩnh điện
endocrinology: khoa nội tiết
enlightenment: làm rõ ràng, giác ngộ
extracellular: khác thường
expeditionary: viễn chinh 
expressionism: biểu thị
ethnocentrism: chủ nghĩa dân tộc
extragalactic: ngoài thiên hà
equilibristic: cân bằng
equilibration: thăng bằng
enthusiastic: tận tâm
exploitation: khai thác, sự lợi dụng
encroachment: sự lấn chiếm
experiential: dựa theo kinh nghiệm
econometrics: kinh tế lượng
excruciating: đau đớn, dữ dội
electrolysis: điện phân, điện từ
electrolytic: điện phân
equivocation: không rõ ràng
exterminator: kẻ ám sát 
emotionalism: cảm động
expressivity: biểu cảm
environment: môi trường
engineering: kỹ thuật
experienced: kinh nghiệm
educational: phương pháp giáo dục
effectively: hiệu quả
exploration: sự khám phá, thăm dò
examination: kiểm tra
encouraging: khích lệ, khuyến khích
expectation: sự mong đợi
endorsement: chứng thực
explanatory: giải thích
exponential: số mũ
egalitarian: bình đẳng
emplacement: sự thay thế
emotionless: vô cảm
excrescence: sự xuất hiện
exclamatory: cảm thán, thán từ
especially: đặc biệt
everything: mọi thứ
employment: nơi làm việc, công việc
enterprise: doanh nghiệp
eventually: cuối cùng, sau cùng
expression: biểu hiện, cách biểu lộ
exhibition: buổi triển lãm
enrollment: ghi danh
excellence: xuất sắc
enthusiasm: hăng hái
everywhere: khắp nơi
excitement: sự phấn khích
experiment: thí nghiệm
engagement: hôn ước, lễ đính hôn
education: giáo dục
executive: điều hành
excellent: xuất sắc
extensive: sâu rộng, hiểu biết rộng
effective: có hiệu lực
expertise: chuyên môn
expansion: sự bành trướng
establish: thành lập
efficient: có hiệu quả
emergency: trường hợp khẩn cấp
existence: sự tồn tại
evolution: sự phát triển
emotional: đa cảm
economics: kinh tế học
everybody: mọi người
exception: ngoại lệ
excessive: quá đáng
explosion: vụ nổ
exclusion: loại trừ 
economic: kinh tế
exchange: trao đổi
evidence: chứng cớ
exercise: luyện tập, thực hành
earnings: thu nhập
estimate: ước tính, lượng giá
exposure: sự phơi nhiễm, sự gian xảo
everyday: mỗi ngày
evaluate: giá trị
enormous: to lớn, khổng lồ
engineer: kỹ sư
example: ví dụ
eastern: phía Đông
exactly: chính xác
expense: chi phí
explain: giải thích
excited: bị kích thích
element: thành phần
edition: sự xuất bản, phiên bản
exhibit: vật trưng bày, triển lãm
endless: mãi mãi
embassy: đại sứ quán
evident: hiển nhiên
either: hoặc
enough: đủ 
effect: ảnh hưởng 
ensure: đảm bảo 
energy: năng lượng
expect: chờ đợi
easily: dễ dàng
except: ngoại trừ
enable: kích hoạt
estate: động sản
entire: toàn bộ
effort: cố gắng
equity: công bằng
engine: động cơ
extent: mức độ
every: mỗi
early: sớm
eight: số tám
enjoy: thích thú
event: sự kiện
earth: trái đất
eagle: đại bàng
each: mỗi
easy: dễ dàng
exit: lối thoát
exam: ví dụ
end: kết thúc
eat: ăn uống
fingerprintings: dấu vân tay
featherstitched: lông vũ
featherbeddings: chăn lông vũ
federalizations: liên bang
ferociousnesses: hung dữ
familiarization: làm quen, thói quen
fantastications: những điều kì diệu
fanaticalnesses: sự cuồng tín
faithlessnesses: những người không trung thành
favorablenesses: những điều thuận lợi
fashionableness: hợp thời trang
fundamentalism: chủ nghĩa cơ bản
ferromagnesian: sắt từ
fructification: kết trái
friendlinesses: thân thiện 
frictionlessly: không ma sát
fundamentalist: người theo chủ nghĩa chính thống
functionality: chức năng
fragmentation: phân mảnh, mảnh vỡ
ferroelectric: chất sắt điện
fortification: vững chắc, sự củng cố
foreknowledge: tiên tri
facilitation: tạo điều kiện, dễ dàng
fibrillation: rung tim
freestanding: hạ cánh tự do
fluorescence: tính huỳnh quang
fountainhead: nguồn gốc 
fenestration: sự tổng hợp
frontiersman: biên phòng
flamethrower: súng phun lửa
fundamental: cơ bản
furthermore: hơn nữa
forthcoming: sắp tới, sắp đến
frustration: thất vọng, phản kháng
fashionable: hợp thời trang
fascinating: hấp dẫn, quyến rũ
fascination: mê hoặc
fundraising: gây quỹ
familiarity: quen thuộc, tính thân mật
forgiveness: sự tha thứ
fingerprint: vân tay
foundation: nền tảng, thiết lập
frequently: thường xuyên
functional: chức năng
friendship: tình bạn
federation: liên kết
facilitate: tạo điều kiện
formidable: ghê gớm, dữ dội
fellowship: tình bằng hữu
financial: tài chính
following: theo dõi
framework: khuôn khổ
furniture: đồ đạc
frequency: tần số
formation: sự hình thành
forgotten: bị lãng quên
franchise: chuỗi
fortunate: may mắn
freelance: nghề tự do
function: chức năng
facility: cơ sở
friendly: thân thiện
familiar: quen biết
firewall: tường lửa
forecast: dự báo
floating: nổi, nổi trên mặt nước
feedback: phản hồi
festival: lễ hội
fraction: phân số
further: thêm nữa
forward: hiển nhiên, ở đằng trước
foreign: ngoại quốc
finance: tài chính
feature: đặc tính
federal: liên bang
finding: phát hiện
feeling: cảm giác
future: tương lai
family: gia đình
father: bố
friend: bạn
first: thứ nhất, đầu tiên
found: tìm ra
field: cách đồng
force: lưc lượng 
front: trước mặt
focus: tiêu điểm
floor: sàn nhà
fight: đánh nhau
fixed: cố định
from: từ
four: số bốn
find: tìm
face: mặt
food: thức ăn
free: miễn phí
fact: trường hợp, thực tế
fish: con cá
fee: phí
fox: con cáo
fun: thú vị
fly: bay
gastroenteritis: viêm dạ dày ruột
garrulousnesses: sự tuyệt vời
geochronologies: địa lý
gastronomically: nói về mặt kinh tế học
governmentalism: chủ nghĩa chính quyền
gravitationally: hấp dẫn
groundbreaking: động thổ
generalization: sự khái quát
geosynchronous: không đồng bộ địa lý
granddaughter: cháu gái
gratification: sự hài lòng, sự vừa ý
gubernatorial: thống đốc
geomorphology: địa mạo
groundskeeper: người trông coi
gastrocnemius: dạ dày
groundbreaker: tàu ngầm
geochronology: địa lý học
geochemistry: địa hóa học
governorship: quyền thống đốc
geriatrician: bác sĩ nhi khoa
gastrulation: đau bụng
grandmother: bà nội/bà ngoại
grandfather: ông nội/ông ngoại
generalized: tổng quát
gingerbread: bánh gừng
gravimetric: trọng lực, trọng lượng
grammatical: ngữ pháp
goaltending: làm mục tiêu, săn bàn
grandparent: ông bà
gerontology: ngành nghiên cứu tuổi già
gastronomic: kinh tế học
gallbladder: túi mật
government: chính phủ
generation: thế hệ
geographic: địa lý
girlfriend: bạn gái
graduation: tốt nghiệp
goalkeeper: thủ môn
generosity: hào phóng, rộng lượng
gynecology: phụ khoa
groundwork: cơ sở
greenfield: cánh đồng xanh
generally: nói chung là
guarantee: bảo hành
gathering: thu nhập
geography: môn địa lý
gentleman: quý ông, quý phái
generator: máy phát điện
gratitude: lòng biết ơn
geometric: hình học
glamorous: hào nhoáng
goldsmith: thợ kim hoàn
guerrilla: du kích
guidance: hướng dẫn
generate: tạo ra
graphics: đồ họa
governor: thống đốc
grateful: tri ân
guardian: người giám hộ
generous: hào phóng
goodwill: thiện chí 
genomics: bộ gen
goodness: nhân hậu
greeting: lời chào
grouping: phân nhóm
geometry: hình học
general: chung
greater: lớn hơn
gallery: bộ sưu tập
genuine: chính hãng
genetic: di truyền 
gravity: trọng lực
graphic: đồ họa
gateway: cổng vào
goodbye: tạm biệt 
garment: quần áo
growth: sự phát triển
global: toàn cầu
ground: đất
golden: vàng
garden: vườn
guilty: tội lỗi
gender: giới tính
gather: tụ họp
gentle: dịu dàng
genius: thiên tài
group: nhóm
great: tuyệt
green: màu xanh
glass: cốc thủy tinh
grown: tăng
grade: cấp
grape: nho
good: tốt
give: tặng, đưa
game: trò chơi
goal: mục tiêu, bàn thắng
gain: thu được
grow: lớn lên
gold: vàng
girl: cô gái
gene: gia hệ
grid: lưới
gray: màu xám
gate: cổng
hospitalization: nhập viện
humanitarianism: chủ nghĩa nhân đạo
historiographer: nhà sử học, sử ký
hyperactivities: tăng động
hypermobilities: siêu linh hoạt
historiography: lịch sử học
hypersensitive: quá mẫn cảm
hypoallergenic: không gây dị ứng
histochemistry: hóa học
hyperconscious: siêu ý thức
habitabilities: thói quen
headquartering: trụ sở chính
heterogeneous: không đồng nhất
homosexuality: đồng tình luyến ái
hydroelectric: thủy điện
heartbreaking: đau lòng
housecleaning: dọn nhà
hallucination: ảo giác
hundredweight: trăm cân
headquarters: trụ sở chính
humanitarian: nhân đạo
hypothetical: giả thuyết
hypertension: tăng huyết áp 
handkerchief: khăn tay
housekeeping: dọn phòng
hypertensive: tăng huyết áp
heartbreaker: người làm tan nát trái tim
hospitality: lòng hiếu khách
handicapped: tật nguyền, bất lợi
heavyweight: hạng nặng
homogeneous: đồng nhất 
handwriting: chữ viết tay
humiliation: sự sỉ nhục
hairdresser: thợ cắt tóc
housekeeper: người quản gia
historical: lịch sử
horizontal: ngang, nằm ngang
helicopter: máy bay trực thăng
homosexual: đồng tính luyến ái
hemisphere: bán cầu
hypothesis: sự giả thuyết
hematology: huyết học
hesitation: do dự
honourable: danh giá, vẻ vang
hysterical: loạn trí
harmonious: hài hòa
household: hộ gia đình
happening: đang xảy ra, biến cố, tai họa
highlight: điểm nổi bật
historian: nhà sử thi
hierarchy: hệ thống cấp bậc
hopefully: hi vọng
hurricane: bão
honorable: danh giá
hostility: thù địch
honeymoon: tuần trăng mật
hospital: bệnh viện
hardware: phần cứng
handling: sự điều khiển
heritage: gia tài
humanity: nhân loại
historic: lịch sử
homeless: vô gia cư
highland: cao nguyên
horrible: kinh khủng, ghê gớm, khiếp sợ
however: tuy nhiên, thế nhưng
himself: bản thân anh ấy
history: lịch sử
holding: giữ, chiếm hữu
helping: giúp đỡ
hundred: trăm
holiday: kỳ nghỉ
herself: bản thân cô ấy
housing: nhà ở
husband: chồng
healthy: khỏe mạnh, lành mạnh
health: sức khỏe
happen: xảy ra
handle: xử lý
hardly: khó khăn
hungry: đói bụng
horror: kinh dị, ghê rợn
heaven: thiên đường
hollow: rỗng
house: ngôi nhà
human: nhân loại
heart: trái tim
hotel: nhà nghỉ
happy: vui vẻ
heavy: nặng
horse: con ngựa
hence: vì thế
hurry: vội
have: có
high: cao
here: ở đây, tại đây
help: giúp đỡ
home: nhà
hand: bàn tay
hope: hi vọng
hour: giờ
huge: khổng lồ
had: có
hat: cái mũ
hit: đánh
his: của anh ấy
her: của cô ấy
how: thế nào
nstrumentation: thiết bị đo đạc
interchangeable: có thể hoán đổi cho nhau
indemnification: sự bồi thường
intercollegiate: liên trường
incompatibility: không tương thích
inconsequential: không đáng kể
impressionistic: nghệ sĩ ấn tượng
interscholastic: xen kẽ
instrumentalist: nhạc cụ, nhạc công
incomprehension: sự hiểu biết
instrumentality: công cụ
intellectualism: chủ nghĩa trí tuệI
infrastructure: cơ sở hạ tầng
identification: nhận biết
interpretation: diễn dịch
interdependent: liên kết với nhau, phụ thuộc vào nhau
insurmountable: không thể vượt qua
indiscriminate: bừa bãi
interpretative: phiên dịch
intelligentsia: người thông minh, người khôn ngoan
indestructible: không thể phá hủy
impressionable: không thể ấn tượng
irreconcilable: không thể hòa giải
insignificance: không đáng kể
interplanetary: liên hành tinh
inconsiderable: không thể coi thường
international: quốc tế
investigation: cuộc điều tra
institutional: thể chế
incorporating: kết hợp
inappropriate: không thích hợp
indispensable: cần thiết
investigative: điều tra
insignificant: tầm thường
inconvenience: bất lợi, không thuận tiện
instantaneous: tức thì
interpersonal: giữa các cá nhân
irresponsible: vô trách nhiệm
introduction: giới thiệu
intelligence: sự thông minh
intellectual: trí thức
incorporated: kết hợp
independence: sự độc lập
installation: cài đặt
intermediate: trung gian
instrumental: nhạc cụ
illustration: hình minh họa
insufficient: không đủ
interference: giao thoa
inflammatory: gây viêm
introductory: giới thiệu 
inconsistent: không nhất quán
information: thông tin
independent: độc lập
immediately: tức thì
interesting: thú vị
improvement: sự tiến bộ
integration: hội nhập
institution: tổ chức
intelligent: thông minh
interactive: tương tác
incorporate: kết hợp
instruction: chỉ dẫn
interaction: sự tương tác
investigate: điều tra
imagination: trí tưởng tượng
investment: sự đầu tư 
individual: cá nhân
industrial: công nghiệp
initiative: sáng kiến
importance: tầm quan trọng
interested: thú vị
innovative: sáng tạo
impossible: không thể nào
innovation: sự đổi mới
impressive: ấn tượng
instrument: dụng cụ
indication: sự chỉ dẫn
important: quan trọng
insurance: bảo hiểm
institute: học viện
immediate: ngay tức khắc
influence: ảnh hưởng
interview: phỏng vấn
intention: chú ý
introduce: giới thiệu
interface: giao diện
implement: triển khai thực hiện
inflation: lạm phát
inventory: hàng tồn kho
infection: nhiễm trùng
increase: tăng
included: bao gồm
involved: bị liên lụy
internal: nội bộ
indicate: nội bộ
intended: dự định
identify: nhận định
informed: thông báo
interior: nội địa
instance: phiên bản
include: bao gồm
improve: tiến bộ, cải thiện 
initial: ban đầu
instead: thay vì
imagine: tưởng tượng
intense: mãnh liệt
insight: sáng suốt
instant: tức thì
income: thu nhập = earning
impact: sự va chạm
inside: phía trong
indeed: thật
island: đảo
intend: ý định, dự định
injury: thương tật
invest: đầu tư
import: nhập khẩu
ignore: làm lơ
invite: mời
issue: vấn đề
image: hình ảnh
ideal: lý tưởng
index: mục lục
input: đầu vào
inner: bên trong
imply: bao hàm, ngụ ý
inter: hấp dẫn
irony: trớ trêu
idiom: cách diễn đạt
idea: ý tưởng
item: mục
icon: biểu tượng
judiciousnesses: sự phán xét
jurisprudential: luật học
justifiability: tính hợp lý, tính chất hợp lý
justiciability: tính thẩm định
justifications: biện minh
jollifications: điều kiện
justification: sự biện hộ
jurisprudence: khoa luật pháp, luật học
justificatory: biện minh
justificative: để bào chữa, để biện hộ
journalistic: báo chí
juvenescence: thời kỳ thanh thiếu niên
juvenilities: vị thành niên
judicatories: giám khảo
joyfulnesses: niềm vui
justifiable: có thể biện minh được
justiciable: bị thuộc quyền xét xử
journeywork: hành trình
jactitation: phô trương
journalizes: viết nhật ký
journalist: nhà báo, ký giả
journalism: báo chí
jeopardize: hủy hoại, liều mạng
judgmental: phán xét
journeyman: người hành trình
judgements: bản án, sự xét xử
judiciary: cơ quan tư pháp
jewellery: đồ kim hoàn
juridical: pháp lý
jellyfish: con sứa
judicious: khôn ngoan
jailhouse: nhà tù
juxtapose: để cạnh nhau
junction: giao lộ, chờ gặp nhau
jeopardy: nguy cơ, cảnh hiểm nghèo
jubilant: hâm hoan, mừng rỡ
joystick: cần điều khiển
juncture: thời cơ
jaundice: bệnh vàng da, sự ghen tức
jalapeno: ớt
justice: sự công bằng
journal: tạp chí
journey: hành trình
jealous: ghen tuông
justify: bào chữa, biện hộ
jointly: chung, cùng nhau
juniper: cây bách xù
jubilee: lễ kỷ niệm
junior: trẻ em
jungle: rừng nhiệt đới, mớ hỗn độn
jacket: áo khoác
joint: chung, khớp
juice: nước ép
judge: thẩm phán
jolly: vui vẻ
jakes: trò đùa
japan: Nhật Bản
just: chỉ
jump: nhảy
job: nghề nghiệp
joy: vui sướng
kindergarteners: trường mẫu giáo, trẻ mẫu giáo
kremlinologists: các nhà nghiên cứu về điện
kindheartedness: lòng tốt
knickerbockers: đồ đan lát
knightlinesses: hiệp sĩ
knowledgeable: có kiến thức, thông minh, hiểu rõ
kinematically: động học
kaleidoscopes: kính vạn hoa
kindergarten: mẫu giáo 
kitchenware: đồ bếp, dụng cụ làm bếp
kitchenette: bếp nhỏ
kindhearted: tốt bụng
knucklehead: đốt ngón tay 
kleptomania: tật ăn cắp
kingfisher: bói cá, chim bói cá
knighthood: hiệp sĩ, giai cấp
kickboxing: kick-boxing
kinematics: động học
knickknack: đồ đạc, bàn ghế
knowledge: hiểu biết, học thức
knock-down: giá thấp nhất, có thể tháo ra được
keystroke: tổ hợp phím
keratitis: viêm giác mạc
kickboard: ván trượt chân
kingcraft: vua lừa đảo
kindness: lòng tốt, tử tế
knitting: sự dính liền, sự kết hợp
kinetics: động học
knockout: hạ gục
kangaroo: con chuột túi
kingship: vương quyền, vương vị
knitwearh: hàng dệt kim
knickers: quần đùi
kerosene: dầu hỏa
keepsake: vật kỷ niệm
kindling: kích thích
kingdom: vương quốc
keeping: duy trì
kitchen: bếp
keyword: từ khóa
killing: giết, sát trùng
knowing: biết, thông minh, trang nhã
kickoff: bắt đầu
keynote: điểm chủ yếu, bài phát biểu chính thức
kindred: giống nhau, tương trợ 
ketchup: sốt cà chua
killed: làm ngã, bị giết
knight: hiệp sỹ, người đi lang thang
kindly: vui lòng, lòng nghĩa hiệp, có lòng tốt
keeper: người bảo quản, thủ môn
knives: con dao, dao găm
kettle: ấm đun nước, việc rắc rối
kidnap: bắt cóc, bắt giữ
keypad: bàn phím
kiddie: đứa trẻ
known: đã biết, nhận ra
knife: con dao
knock: gõ cửa, đụng chạm, đụng phải
kitty: mèo con, mèo nhỏ
knack: khéo léo, sự khéo tay
karma: nghiệp
keep: giữ, nắm
kind: tốt bụng, tử tế
king: vua
kiss: nụ hôn
key: chìa khóa
kid: đứa trẻ
lymphadenopathy: nổi hạch
lymphadenitises: hạch
lucrativenesses: sinh lợi
ludicrousnesses: sự lố lăng
logographically: về mặt logic
longsightedness: cận thị nặng
laboriousnesses: sự cần cù
legitimizations: luật pháp
lateralization: quá trình hóa đá
latitudinarian: người latinh
lasciviousness: sự dẻo dai
landlessnesses: không có đất 
legitimatizing: hợp pháp hóa
lignifications: giải nghĩa
lifelikenesses: sống động như thật
lithologically: về mặt ngữ văn
liberalization: tự do hóa
laughingstock: trò cười
lackadaisical: thiếu kinh nghiệm
lexicographer: nhà nghiên cứu từ vựn học
lymphadenitis: viêm hạch
lymphocytosis: tăng bạch cầu
logicalnesses: tính logic
lucrativeness: khả năng sinh lợi 
longitudinal: theo chiều dọc
lighthearted: nhẹ dạ cả tin
laryngoscope: soi thanh quản
listenership: thính giả
labyrinthine: mê cung
luminescence: phát quang
liquefaction: hóa lỏng
longshoreman: người làm ở hải cảng
lexicography: từ điển học 
legislation: pháp luật, sự lập luận
legislative: lập pháp, quyền lập pháp
legislature: cơ quan lập pháp
libertarian: người theo chủ nghĩa tự do
linguistics: ngôn ngữ học
lightweight: nhẹ cân
loudspeaker: máy phát thanh, loa ngoài
leadership: khả năng lãnh đạo
literature: văn chương
laboratory: phòng thí nghiệm
likelihood: khả năng xảy ra
legitimate: hợp pháp, đích tôn
limitation: sự hạn chế, giới hạn
liberation: sự tự do, phóng thích
linguistic: ngôn ngữ, thuộc về ngôn ngữ học
lieutenant: trung úy
locomotive: đi du lịch
lighthouse: ngọn hải đăng
liberalism: chủ nghĩa tự do
locomotion: sự chuyển động, sự vận động 
lymphocyte: tế bào
letterhead: bìa thư
legitimize: hợp pháp hóa
linerboard: tấm lót
lamentable: than thở, đáng thương, tội nghiệp
liberalize: tự do hóa
landlocked: ở giữa đất liền
liability: trách nhiệm pháp lý
landscape: phong cảnh 
lifestyle: cách sống
legendary: huyền thoại
liquidity: tính trong suốt
literally: theo nghĩa đen
logistics: hậu cần, theo dõi hậu cần, công ty hậu cần
lucrative: sinh lợi
lightning: tia chớp
luxurious: sang trọng
leasehold: nhà cho mướn, cho thuê
localized: chậm chân tại chỗ, bản địa
limestone: đá vôi
lunchtime: giờ ăn trưa
ludicrous: lố bịch
language: ngôn ngữ
learning: học tập
location: vị trí
literary: văn học
lifetime: cả đời
lighting: thắp sáng
leverage: tận dụng
landlord: chủ nhà, chủ quán
likewise: tương tự, hơn nữa
literacy: trình độ học vấn
laughter: tiếng cười, cười ầm lên
limiting: hạn chế, giới hạn
landmark: phong cảnh
lecturer: người giảng dạy, giảng viên
luncheon: bữa ăn trưa, tiệc trưa
leading: sự chỉ huy, dẫn đầu
limited: giới hạn
library: thư viện
leisure: rảnh rỗi, giải trí
loyalty: lòng trung thành
logical: hợp lý
license: giấy phép, sự cho phép
landing: đổ bộ, lên bờ
listing: sự lắng nghe, danh sách
lasting: bền vững, sự trường cửu
leather: da
lecture: bài học, cuộc diễn thuyết
leasing: cho thuê, giao kết
lengthy: dài dòng
little: ít
leader: thủ lĩnh, người chỉ huy
likely: có khả năng, có lẽ thật
letter: chữ cái
latest: muộn nhất
living: cuộc sống
launch: ra mắt
league: liên đoàn, liên minh
length: chiều dài
latter: sau này, chỉ vật sau cùng
labour: nhân công, lao động
losing: thua, thất lạc
linked: đã liên kết
liquid: chất lỏng, êm ái
local: địa phương, bản địa
large: lớn, rộng rãi
level: trình độ, cấp bậc
lower: thấp hơn, giảm bớt
light: ánh sáng
later: sau đó
legal: hợp pháp, thuộc về pháp luật
leave: rời đi 
learn: học tập
links: liên kết
least: ít nhất, nhỏ nhất
limit: giới hạn
lease: cho thuê
lunch: bữa trưa
lucky: may mắn
laugh: cười, cười rộ lên
lover: người yêu
liver: gan
lobby: phòng chờ, sảnh đợi
like: thích
look: nhìn
long: dài
last: cuối cùng
loan: khoản vay, tiền vay mượn
love: tình yêu
list: danh sách
law: luật sư
lie: nói dối 
leg: chân
multiprocessing: đa chế biến, đa xử lý
multifunctional: đa chức năng
monounsaturated: chất béo, không bão hòa đơn
mischaracterize: nhầm lẫn, hiểu sai
misconstruction: sự nhầm lẫn
microprocessor: bộ vi xử lý
multiplication: phép nhân
microstructure: cấu trúc vi mô
macroeconomics: kinh tế vĩ mô
mountaineering: leo núi
multifactorial: đa yếu tố
multiplicative: phép nhân
microeconomics: kinh tế vi mô
misappropriate: thích hợp
metalinguistic: kim loại
microevolution: tiến hóa vi mô
multinational: đa quốc gia
mediterranean: địa trung hải
merchandising: buôn bán
multicultural: đa văn hóa
manifestation: biểu hiện, sự biểu lộ
miscellaneous: điều khoản khác, lẫn lộn
microcomputer: máy vi tính
misunderstood: hiểu lầm, hiểu không rõ
misconception: ngộ nhận
magnification: phóng đại
metamorphosis: sự biến hình
manufacturer: nhà sản xuất, nhà chế tạo
metropolitan: thuộc về thủ đô, dân ở thủ đô
modification: sửa đổi, sự giảm bớt
mathematical: toán học, thuộc về toán học
manipulation: thao tác, sự vận động
metaphysical: siêu hình
multilateral: đa phương
manipulative: thao túng, lôi kéo
municipality: thị trấn, thành phố
maintenance: bảo trì, tiền bảo dưỡng
manufacture: sản xuất
measurement: sự đo lường, đo đạc
marketplace: thương trường
methodology: phương pháp luận, phương pháp nghiên cứu
mathematics: toán học
magnificent: tráng lệ, lộng lẫy
merchandise: hàng hóa
multifamily: đa gia đình
meaningless: vô nghĩa
multiplayer: nhiều người chơi
ministerial: bổ trợ, bộ trưởng
management: sự quản lý
membership: tư cách hội viên
materially: vật chất
multimedia: đa phương tiện
mechanical: không suy nghĩ, cơ khí
meaningful: có ý nghĩa
mainstream: xu hướng
misleading: gây hiểu lầm
motivation: động lực 
mysterious: huyền bí
meanwhile: trong lúc ấy, trong khi ấy
mechanism: cơ chế, sự tổ chức
municipal: thuộc về đô thị
migration: di cư
machinery: máy móc
molecular: phân tử, thuộc về phân tử
mortality: tử vong
magnitude: tầm quan trọng
material: nguyên liệu, vật liệu
majority: số đông, đa số
military: quân đội, quân nhân
maintain: duy trì
movement: sự di động, phong trào
magazine: tạp chí
multiple: nhiều, kép
minister: bộ trưởng, mục sư
mortgage: thế chấp, sự cho mượn
midfield: tiền vệ
million: triệu
manager: người quản lý
meeting: cuộc họp, cuộc gặp gỡ
morning: buổi sáng
meaning: có ý tốt, ý nghĩa
medical: y khoa
measure: đo lường, đo kích thước
message: tin nhắn, thông điệp
machine: máy móc
market: thị trường
member: thành viên
middle: giữa
matter: vấn đề
moving: di chuyển
moment: chốc lát
minute: phút
method: phương pháp
modern: hiện đại
memory: ký ức
master: bậc thầy
might: có thể
major: chính
money: tiền
march: tháng ba
month: tháng
media: truyền thông
match: trận đấu
music: âm nhạc
movie: phim
more: hơn, nhiều hơn nữa, thêm
most: hơn hết, phần lớn
many: vô số, nhiều
meet: gặp gỡ
move: di chuyển
mind: săn sóc
main: chủ yếu
meat: bữa ăn
milk: sữa
notwithstanding: bất chấp, tuy nhiên, thế mà
nonprescription: không theo đơn
neurophysiology: sinh lý học thần kinh
nonprofessional: không chuyên nghiệp
noncontributory: không thuộc quyền sở hữu
neuropsychology: tâm thần kinh
nonintervention: không can thiệp
neutralizations: trung lập
neurofibrillary: sợi thần kinh
nearsightedness: cận thị
nationalization: cho nhập tịch
normativenesses: quy phạm
nonhierarchical: không có thứ bậc
nanotechnology: công nghệ nano
nondestructive: không phá hủy
noncoopertion: không hợp tác
nondistinctive: không phân biệt
nondeductible: không được khấu trừ
noncompliance: không tuân thủ, không bằng lòng
nonconformity: không phù hợp
nonconformist: người không tuân thủ
nonproductive: không hiệu quả, không sản xuất
nonnegotiable: không thể thương lượng
nonreflecting: không phản ánh
nevertheless: tuy nhiên
notification: thông báo
neighborhood: khu vực lân cận
naturalistic: tự nhiên
negotiations: đàm phán, sự đổi chác
neglectfully: lơ đễnh
nephropathic: suy thận
necessarily: nhất thiết
negotiation: sự giao dịch
nationality: quốc tịch
necessitate: cần thiết, bắt buộc
neutralized: vô hiệu hóa
neutralizer: chất trung hòa
newsreaders: người đọc tin tức
nationwide: thế giới chung, toàn quốc
newsletter: bảng tin
noticeable: đáng chú ý, thấy rõ ràng
nomination: sự đề cử, sự bình chọn
navigation: dẫn đường
negligence: thiếu trách nhiệm
negligible: có thể bỏ qua, không đáng kể
neglectful: không chú ý, bỏ bê, bỏ quên
nightshade: cây bạch anh, cây mồng tơi
necessary: cần thiết
newspaper: báo
naturally: một cách tự nhiên
narrative: tường thuật
negotiate: đàm phán
necessity: sự cần thiết
nutrition: dinh dưỡng
nightmare: ác mộng
northeast: đông bắc
numerical: thuộc về số
neighbour: người láng giềng, hàng xóm
normative: quy phạm, giá trị
nightlife: cuộc sống về đêm
nightfall: đêm xuống, lúc mặt trời lặn
northern: phương bắc
national: quốc gia
notebook: sổ ghi chép
nowadays: ngày nay
novation: nâng cao
neckwear: khăn choàng cổ
negligee: người da đen
network: mạng lưới
nothing: không có gì
natural: tự nhiên
nuclear: nguyên tử
neither: cũng không
nervous: lo lắng
naughty: nghịch ngợm
number: số
nearly: gần, giống lắm, giống hệt
notice: chú ý
normal: bình thường
nobody: không ai cả
narrow: hẹp
nearby: lân cận
nephew: cháu trai
napkin: khăn ăn
noodle: bún
newbie: thành viên
never: không bao giờ 
needs: cần
north: hướng Bắc
noise: ồn ào 
nurse: y tá
niece: cháu gái
noway: không đời nào
next: tiếp theo
need: cần
name: tên
neck: cổ
nose: mũi
nail: móng tay
new: mới
now: bây giờ
xenogamy: Sự lai chéo
xanthous: Vàng (da, tóc)
xebec: Thuyền Xebec 
xylophone: Đàn phiến gỗ
xenon: Khí xenon
xerophyte: Thực vật chịu hạn
xenphobla: Sự bài ngoại
xennolth: Đá trong khối phun trào từ núi lửa
xylocarp: Quả mộc, quả gỗ
xe: Kỷ nguyên tố xennon
xenanthemum: cây lai chéo
xerodemma: Bệnh khô da
xerogrphy: Tự sao chụp tính điện
xyloid: Có gỗ, dạng gỗ; có linin
xerophthalmia: Bệnh khô mắt
xerophilous: thích nghi điều kiện khô hạn, chịu hạn
xerox: Máy sao chụp
xenophobe: Người bài ngoại
xylograph: Bản khắc gỗ
xerophilous: Ưa khô, chịu hạn (cây)
xylography: Thuật khắc gỗ
zigzag: Ngoằn ngoèo
zone: Khu vực, miền, vùng
zenoism: chủ nghĩa khắc kỷ
zahaglione: Món tráng miệng của người Ý
zaffre: Phẩm lục
zeltgelst: lý tưởng
zero number: Số không
zany: Nhố nhăng, kì cục
zappy: Sống động, sôi nổi, hoạt bát
zealet: Người cuồng tín, người quá khích
zed: Chữ Z
zemlndar: Điền chủ, địa chủ
zamboo: Người lai da đen.
zenistvo: Hội đồng tự quản địa phương; vải mỏng
zealous: Sốt sắng, hăng hái, có nhiệt huyết
zincoggraph: bản in kẽm
zen: Đạo Thiền
zenth: Thiên định; điểm cao nhất
zeal: Lòng sốt sắng, lòng hăng hái
zephyr: Văn gió mát, gió hiu hiu, gió nhẹ
zeta: Mẫu tự thứ 6 trong bảng chữ cái của Hy Lạp
zilch: Lóng không có gì
zag: Sự đổi hướng đột ngột trên đường dích dắc.
zlion: Tục số lớn, vô hạn
zillionaire: Nhà giàu kết sù, kẻ giàu sụ
zinc: kēm
zincoraphy: Thuật khắc bản kẽm
zeta: Mẫu tự thứ 6 trong bảng chữ cái của Hy Lạp
zincoggraph: Bản in kẽm
zoo: Vườn thú
zeabra: Ngựa Vằn
optoelectronics: quang điện tử
omnidirectional: đa hướng
overrepresented: đại diện quá mức
ophthalmologist: bác sĩ nhãn khoa (nhãn khoa y học)
orthopsychiatry: khoa tầm thần học  
ontogenetically: về mặt di truyền
operativenesses: tác nghiệp
occidentalizing: ngẫu nhiên
obstructionisms: chướng ngại vật
obstinatenesses: sự cố chấp
obsessivenesses: ám ảnh
oversaturations: dư thừa
observationally: quan sát
observabilities: khả năng quan sát
oceanographical: hải dương học
objectification: sự khách quan hóa
offensivenesses: sự xúc phạm
osmoregulations: lời chúc mừng
otolaryngology: khoa tai mũi họng
osteoarthritis: viêm xương khớp
overpopulation: dân số quá đông
organometallic: kim loại
organochlorine: clo hữu cơ
obstructionist: người cản trở
overcompensate: bù đắp quá mức
overgeneralize: tổng quát hóa quá mức
overoptimistic: quá mức
overprivileged: quá đặc quyền
overcapitalize: thừa sức sống
overscrupulous: vô đạo đức
operationalism: chủ nghĩa hoạt động
overspecialize: quá chuyên môn hóa
overproportion: quá tỷ lệ
oversolicitous: thái quá
ornithological: loại chim chóc
orthographical: chỉnh hình
oscillographic: dao động
ostentatiously: phô trương
openhandedness: cởi mở
onchocerciases: bệnh ung thư
oncogenicities: những người có tội
opportunistic: cơ hội
objectionable: phản đối
ophthalmology: nhãn khoa
orchestration: sự dàn dựng
ornamentation: vật trang trí
overemphasize: nhấn mạnh quá mức
osteomyelitis: viêm tủy xương
overabundance: dư thừa
overqualified: thừa năng lực
oversensitive: không nhạy cảm
overconfident: thừa sự tự tin
oppositionist: người chống đối
overambitious: quá tham vọng
occidentalize: ngẫu nhiên
overdominance: vượt trội
overutilizing: sử dụng quá mức
ovipositional: thuộc về thần tượng
overstatement: phóng đại
overstability: nói quá
overcommitted: thừa nhận
organization: cơ quan, tổ chức, cách cấu tạo, sự giữ gìn
occasionally: thỉnh thoảng
overwhelming: choáng ngợp
osteoporosis: loãng xương
optimization: tối ưu hóa
occupational: nghề nghiệp
overpowering: chế ngự
overestimate: đánh giá quá cao
otherworldly: thế giới khác
ostentatious: phô trương
obstetrician: bác sĩ sản khoa
overcapacity: dư thừa
outplacement: sự thay thế
officeholder: chủ văn phòng
orthographic: chỉnh hình
orienteering: định hướng
oversimplify: đơn giản hóa quá mức
osteosarcoma: u xương
ossification: hóa thạch
obstreperous: chướng tai
overpressure: quá áp
osteomalacia: nhuyễn xương
overcautious: cẩn thận
osteoplastic: chất tạo xương
oscillograph: dao động
overpopulate: dân số quá đông
overfamiliar: quá quen
overregulate: kiểm soát quá mức
overgenerous: quá nhiều
orthogenesis: sự phát sinh
olfactometer: máy đo khứu giác
overmedicate: thái quá
opinionative: cố chấp
orchidaceous: hoa phong lan
overpersuade: quá sức
orthotropous: chỉnh hình
obfuscations: sự xáo trộn
obliterating: xóa sổ
obliteration: sự xóa sổ
opportunity: cơ hội
outstanding: nổi bật
operational: hoạt động
objectivity: tính khách quan
orientation: sự định hướng
observation: quan sát
obstruction: sự cản trở
outsourcing: gia công phần mềm
orthopedics: chỉnh hình
observatory: đài quan sát
originality: độc đáo
overarching: bao quát
oscillation: sự lung lay
orchestrate: dàn dựng
overbearing: hống hách
omnipresent: có mặt khắp nơi
overzealous: quá hăng hái
opinionated: khăng khăng, ngoan cố
opportunist: người cơ hội
overwrought: quá sức
outdoorsman: người ngoài trời
outmaneuver: vượt qua
overweening: tràn ngập
orthostatic: thế đứng
outbuilding: xây dựng
overindulge: quá mức
overbalance: mất thăng bằng
opprobrious: hung dữ
overcorrect: quá đúng đắn
officialese: chính thức
obligation: nghĩa vụ
originally: ban đầu
opposition: sự đối đầu
occurrence: tần suất xảy ra, biến cố
occasional: thỉnh thoảng
occupation: nghề nghiệp
outpatient: bệnh nhân ngoại trú
outrageous: tàn nhẫn
outfielder: tiền vệ
oppression: sự áp bức
ordinarily: bình thường
oppressive: áp bức
ornamental: trang trí
observable: có thể thấy, trông thấy
obligatory: bắt buộc
outperform: vượt trội
ophthalmic: thuộc về mắt
obstetrics: khoa sản
occidental: ngẫu nhiên
outpouring: chảy ra, sự tuôn ra
outlandish: lạ lùng, kỳ dị
orthogonal: trực giao
overburden: bắt gánh vác, quá tải
ostensible: bề ngoài, tự xưng
obliterate: bôi, cạo
overshadow: làm lu mờ, che mắt
oversupply: cung cấp quá mức
overgrowth: phát triển quá mức
omnipotent: toàn năng, thượng đế
omniscient: toàn trí, toàn thức
overbought: mua quá nhiều
overcharge: quá tải
oratorical: hình bầu dục
osteopathy: nắn xương
otherworld: thế giới khác
osmolarity: độ thẩm thấu
outcompete: cạnh tranh
organicism: chủ nghĩa hữu cơ
overcommit: thừa nhận
outstation: trạm dừng chân
operation: hoạt động
otherwise: nếu không thì
ownership: quyền sở hữu
organized: có tổ chức
ourselves: chính chúng ta
objective: mục tiêu
offensive: phản cảm
overnight: qua đêm
outsource: thuê ngoài
offspring: con đẻ, con cái
occupancy: chiếm dụng
orchestra: dàn nhạc
objection: sự phản đối
obsession: ám ảnh
originate: bắt nguồn
obedience: vâng lời, nghe lời
outspoken: thẳng thắn, người ngay thẳng
outskirts: ngoại ô
ordinance: sắc lệnh
offering: chào bán
original: nguyên bản
official: chính thức
overseas: hải ngoại
opposite: đối diện
ordinary: bình thường
operator: nhà điều hành
optional: không bắt buộc
organize: tổ chức
opponent: phản đối
officer: nhân viên văn phòng
outside: ở ngoài
overall: tổng thể
opinion: ý kiến
operate: có tác dụng, vận hành
obvious: hiển nhiên
opening: khai mạc
outlook: quan điểm
offense: xúc phạm
ongoing: đang diễn ra
optimal: tối ưu
observe: quan sát
outline: đề cương
oversee: giám sát
offline: ngoại tuyến
obscure: mờ mịt
outrage: sự phẫn nộ
orderly: có trật tự
overlap: chồng lên nhau
oneself: bản thân
outward: bề ngoài
orchard: vườn cây ăn quả
overdue: quá hạn
offence: xúc phạm
obesity: chứng mập, béo phì
onshore: trên bờ
oceanic: hải dương
ominous: điềm xấu, đáng ngại
obscene: ghê gớm, tục tĩu
ovation: sự reo mừng, sự vui mừng
oversaw: trông nom, giám sát
offload: giảm tải
outback: hẻo lánh
ostrich: con đà điểu
osmosis: sự thẩm thấu
offbeat: khác thường
obviate: xóa sổ
opacity: sự u mê
ordinal: thứ tự
office: văn phòng
option: lựa chọn
obtain: đạt được
object: vật thể, mục đích
output: sức sản xuất, đầu ra
offset: bù lại
oracle: tiên tri, nhà tiên tri
occupy: giữ, chiếm
optics: quang học
overly: quá mức, nhiều quá
opaque: mờ mịt
orient: định hướng
orphan: mồ côi
outcry: phản đối
outlay: ra ngoài
onward: trở đi, xa hơn
outlaw: ngoài vòng pháp luật
occult: huyền bí, bí mật
other: khác
often: thường xuyên
order: đặt hàng
ought: phải
occur: xảy ra
ocean: đại dương
outer: bên ngoài
opera: nhạc kịch
olive: ôliu
onset: sự khởi đầu
organ: cơ quan, đàn organ
optic: quang học
onion: củ hành
oasis: ốc đảo
owing: nợ, thiếu
overt: công khai, rõ ràng
obese: béo phì, bụng phệ
opium: thuốc phiện
otter: con rái cá
only: chỉ
open: mở
obey: tuân theo, vâng lời
once: một lần, ngày xưa
one: một, số một
out: ngoài
old: cũ
oil: dầu
professionalism: sự chuyên nghiệp
personification: nhân cách hóa
psychotherapist: nhà trị liệu tâm lý
pharmacotherapy: liệu pháp dược
photojournalism: phóng viên ảnh
parliamentarian: nghị sĩ, nghị viện, thuộc về nghị sĩ
preregistration: đăng ký trước
preservationist: người bản tồn
preprofessional: chuyên nghiệp
physicochemical: hóa lý
plenipotentiary: toàn quyền, được toàn quyền
parthenogenesis: sinh sản
psychoacoustics: thuốc tâm thần
popularizations: phổ biến
precipitinogens: chất kết tủa
prepresidential: tiền bảo kê
pharmaceutical: dược phẩm
predisposition: khuynh hướng, khuynh hướng về
photosynthesis: quang hợp, sự quang hợp
postmenopausal: tiền mãn kinh
polymerization: sự trùng hợp
proprioception: sự khởi đầu
predestination: sự tiền định
photosensitive: cảm quang
prepublication: sự xuất bản
periodontology: sinh vật học
photochemistry: quang hóa học
parapsychology: tâm lý học
prosthodontics: răng giả
prohibitionist: người cấm đoán
paralinguistic: thuộc về ngôn ngữ
preadolescence: thời kỳ thiếu niên
phytochemistry: hóa thực vật
petrochemistry: hóa dầu
parallelepiped: song song
phytopathology: ngành thực vật học
preconsciously: chính xác
preconditioned: điều chỉnh trước
participation: sự tham gia
psychological: tâm lý
parliamentary: nghị viện
preoccupation: bận tâm
proportionate: tương xứng
pronunciation: cách phát âm
precipitation: lượng mưa
perpendicular: vuông góc
participatory: có sự tham gia
physiotherapy: vật lý trị liệu
preponderance: ưu thế
precautionary: đề phòng
pronouncement: lời tuyên bố
postoperative: hậu phẫu
paraphernalia: vật dụng
protectionism: chủ nghĩa bảo hộ
probabilistic: xác suất
particularly: đặc biệt, cặn kẽ
professional: chuyên nghiệp
presentation: bài thuyết trình
prescription: đơn thuốc
presidential: tổng thống
productivity: năng suất
practitioner: người hành nghề
photographic: chụp ảnh
psychologist: nhà tâm lý học
postgraduate: sau đại học
presbyterian: người già
proportional: cân đối, tỷ lệ thuận
psychiatrist: bác sĩ tâm lý
policyholder: chủ hợp đồng
preferential: ưu đãi
preventative: ngăn ngừa
preparedness: sự chuẩn bị
polarization: sự phân cực
pathological: bệnh lý
peacekeeping: gìn giữ hòa bình
perseverance: kiên trì
philanthropy: từ thiện
proclamation: tuyên ngôn
permeability: thấm
pediatrician: bác sĩ nhi khoa
pharmacology: dược lý học
paramilitary: bán quân sự
pathbreaking: sự phá vỡ
patriarchate: gia trưởng
pacification: sự bình định
proscription: lời tố cáo, sự cấm đoán
premalignant: tiền ác tính
performance: hiệu suất
partnership: sự hợp tác
possibility: khả năng, tình trạng
perspective: góc nhìn cá nhân
participate: tham dự
publication: sự xuất bản, sự công bố
preparation: sự chuẩn bị
programming: lập trình
proprietary: độc quyền
preliminary: sơ bộ
prospective: có triển vọng
personality: nhân vật, nhân cách
progressive: cấp tiến
proposition: mệnh đề, điều dự định
prestigious: uy tín
probability: xác suất
practically: thực tế
prosecution: truy tố, sự theo đuổi
participant: người tham gia
predecessor: người tiền nhiệm
progression: sự tiến triển
problematic: có vấn đề, mơ hồ
provisional: tạm thời
production: sản xuất
particular: cụ thể
population: dân số
philosophy: triết học
percentage: tỷ lệ phần trăm
protection: sự bảo vệ
proportion: tỷ lệ
profitable: có lãi
permission: sự cho phép, sự chấp thuận
profession: nghề nghiệp
personally: cá nhân
prevention: phòng ngừa, sự ngăn cản
productive: năng suất
parliament: nghị viện
perception: nhận thức, sự lý giải
preference: sở thích
phenomenon: hiện tượng
possession: chiếm hữu, thuộc địa
photograph: ảnh chụp, chụp hình
persistent: kiên trì
president: chủ tịch, giám đốc
potential: tiềm năng, tiềm lực
provision: điều khoản, cung cấp, cấp dưỡng
principal: hiệu trưởng, quan trọng, chủ yếu
practical: thực dụng, tiện lợi
principle: nguyên tắc
professor: giáo sư
portfolio: danh mục đầu tư
procedure: thủ tục, phương thức
permanent: dài hạn, luôn luôn, thường xuyên
promotion: thăng chức, cải tiến
prominent: nổi bật
perfectly: hoàn hảo, không khuyết điểm
programme: chương trình
publisher: nhà xuất bản, người phát hành
precisely: tỉ mỉ
pollution: sự ô nhiễm
promising: hứa hẹn, đầy hy vọng
packaging: bao bì
plaintiff: nguyên đơn
passenger: hành khách
precision: độ chính xác, tính rõ ràng
publicity: công khai
possible: khả thi, có thể làm được
position: chức vụ, thái độ
property: bất động sản
provided: cung cấp, thuộc về cung cấp
personal: riêng tư, cá nhân
practice: âm mưu, thực hành
probably: có lẽ
previous: trước, vội vàng, gấp gáp
pursuant: hoàn toàn
powerful: năng lượng
presence: sự hiện diện, sự có mặt
positive: tích cực, cương quyết
purchase: mua bán
pressure: sức ép
progress: phát triển
physical: vật lý, thuộc về vật chất
platform: nền tảng
proposal: đề nghị
priority: sự ưu tiên
producer: người sản xuất
printing: in ấn
pleasure: làm vừa lòng, vui lòng
prospect: tiềm năng
provide: cung cấp
process: quá trình, quy trình
private: riêng tư
project: dự án
problem: vấn đề
product: sản phẩm
present: cho đến nay, hiện tại
perhaps: có lẽ, không chừng
program: chương trình
primary: sơ cấp
popular: phổ biến
purpose: mục đích
percent: phần trăm
partner: đồng ngiệp, bạn đồng hành
picture: bức tranh, bức ảnh
patient: kiên nhẫn
payment: sự thanh toán
people: mọi người
public: cộng đồng
period: giai đoạn
person: người
policy: chính sách
police: cảnh sát
profit: lợi nhuận
proper: thích hợp
prison: nhà tù
plenty: sự chan chứa
picked: hái, nhặt
proven: chứng minh
pursue: đuổi theo, theo đuổi
partly: từng phần, từng đoạn
prince: hoàng tử
patent: bằng sáng chế
prefer: thích hơn
place: địa điểm
power: quyền lực
party: bữa tiệc
phone: điện thoại
paper: tờ giấy
plant: cây cối
prime: tội phạm
prior: trước, nguyên thủy, đầu tiên
prove: chứng minh
phase: biểu tượng, giai đoạn
piece: cái, giá
proud: tự hào, kiêu căng
peace: thái bình, sự thanh bình
panel: bảng điều khiển
prize: giải thưởng
plate: đĩa, tấm ổ khóa
proof: bằng chứng
pilot: phi công
poor: nghèo
pass: vượt qua
peak: đỉnh cao, suy yếu
pink: màu hồng
push: thúc đẩy
quatercentenary: bậc bốn
quarterfinalist: tứ kết
quarrelsomeness: cãi vã
querulousnesses: kỳ quặc
quintessential: tinh túy, thuộc về tinh túy
quizzicalities: sự kỳ lạ
quintuplicated: nhân đôi
questionnaires: bảng câu hỏi
qualifications: bằng cấp
quantitatively: định lượng
questionnaire: bảng câu hỏi
quartermaster: quý trưởng
quincentenary: tứ quý
quadripartite: tứ phương
quadrilateral: tứ giác
quadruplicate: gấp bốn
quarterbacked: hỗ trợ
quantitations: định lượng
quantizations: lượng hóa
quantitative: định lượng
questionable: nghi vấn
quarterfinal: tứ kết
quintessence: tinh hoa
quadrivalent: hóa trị bốn
quantization: lượng tử hóa
quarantining: cách ly
quarantines: cách ly
quantifying: định lượng
qualifiedly: đủ tiêu chuẩn
quaveringly: run rẩy
quarrelling: cãi nhau
quotability: khả năng báo giá
quadrangles: hình tứ giác
quizzically: kỳ quặc
quarantines: cách ly
quantifying: định lượng
qualifiedly: đủ tiêu chuẩn
quaveringly: run rẩy
quarrelling: cãi nhau
quotability: khả năng báo giá
quadrangles: hình tứ giác
quizzically: kỳ quặc
quivering: run rẩy
quipsters: câu đố
quitrents: bỏ việc
quadroons: hình tứ giác
quantizer: bộ định lượng
quagmires: vũng lầy
quaggiest: tìm kiếm
qualifies: đủ tiêu chuẩn
question: câu hỏi
quantity: định lượng
quandary: nỗi khó khăn
quotient: thương số
quagmire: vũng lầy
quartile: phần tư
quixotic: anh hùng rơm
quartier: người khai thác
quisling: làm phiền
quietude: im lặng
quickset: hàng rào cây
quietism: chủ nghĩa lập dị
quantile: lượng tử
quiverer: người run rẩy
quirting: nói dối
quippier: vui vẻ hơn
quality: chất lượng
quarter: phần tư
quantum: lượng tử
quarrel: cuộc tranh cãi
quickie: nhanh lên
quibble: không phân minh
quiches: nhanh chóng
quietly: lặng lẽ
queller: người bán hàng
queerer: người hỏi
queries: truy vấn
quester: người hỏi thăm
quarry: mỏ đá
quaint: kỳ lạ
quorum: túc số
quinta: tạ
quiver: run
quanta: lượng tử
quench: dập tắt
queasy: buồn nôn
quoted: trích dẫn
quills: bút lông
queues: hàng đợi
quite: khá, toàn vẹn
quick: nhanh chóng, mau lẹ, gọn gàng
quota: hạn nghạch
query: truy vấn
queer: người kỳ lạ
quell: dập tắt
quirk: kỳ quặc
quash: hủy án
quods: bắt giam
quill: lông nhím
quilt: may chăn
quit: bỏ cuộc
quiz: câu đố
rationalization: sự hợp lý, hợp lý hóa
reaccreditation: công nhận lại
resurrectionist: người hồi sinh
radiotelegraphy: máy ghi âm vô tuyến
remobilizations: sự di dời
remanufacturing: tái sản xuất
rememberability: khả năng nhớ
remonstratively: còn lại
refortification: sự cải tổ
regionalization: khu vực hóa
regularizations: quy định
reductivenesses: giảm bớt
restrictiveness: sự hạn chế
restrictionists: những người hạn chế
retroreflectors: phản xạ
retransmissions: truyền lại
revitalizations: sự hồi sinh
revolutionaries: nhà cách mạng
responsibility: nhiệm vụ
representative: tiêu biểu
representation: sự diễn tả, đại diện
recommendation: sự giới thiệu
reconciliation: hòa giải
reconstruction: tát thiết, trùng tu lại
redistribution: phân phối lại, chia cắt lại
reconnaissance: sự do thám, sự dò xét
reorganization: tổ chức lại
reconstructive: tái tạo
respectability: sự tôn trọng
recapitulation: sự tóm tắt, tóm lược
redevelopments: tái phát triển
redistributive: phân phối lại
remonetization: làm lại
renegotiations: đàm phán lại
responsibility: nhiệm vụ
representative: tiêu biểu
representation: sự diễn tả, đại diện
recommendation: sự giới thiệu
reconciliation: hòa giải
reconstruction: tát thiết, trùng tu lại
redistribution: phân phối lại, chia cắt lại
reconnaissance: sự do thám, sự dò xét
reorganization: tổ chức lại
reconstructive: tái tạo
respectability: sự tôn trọng
recapitulation: sự tóm tắt, tóm lược
redevelopments: tái phát triển
redistributive: phân phối lại
remonetization: làm lại
renegotiations: đàm phán lại
relationship: mối quan hệ
respectively: tương ứng
registration: đăng ký, sự ghi tên
reproduction: sinh sản
recreational: giải trí
reproductive: sinh sản, sinh thực
resurrection: hồi sinh, sự phục hưng
refrigerator: tủ lạnh, phòng lạnh
regeneration: sự cải tạo, sự tái tạo
remuneration: sự khen thưởng, thù lao
receptionist: lễ tân, nhân viên tiếp khách
recollection: hồi ức, tĩnh tâm
radiotherapy: xạ trị
rehabilitate: phục hồi, khôi phục
receivership: sự tiếp nhận
recalcitrant: bướng, ngoan cố
regenerative: tái sinh, tái tạo
reinvigorate: hồi sinh
responsible: chịu trách nhiệm, đáng tin cậy
recognition: sự công nhận, sự thừa nhận
residential: khu dân cư
requirement: sự yêu cầu
replacement: sự thay thế
restoration: sự phục hồi, sự hoàn lại
resignation: sự từ chức
renaissance: sự phục hưng
reservation: sự hạn chế, sự giới hạn
realization: hiện thực hóa
respiratory: hô hấp, thuộc về hô hấp
restriction: sự hạn chế
restrictive: giảm bớt
respectable: đáng kính, đúng đắn
rebroadcast: phát lại
replication: nhân rộng, đáp lại
radioactive: phóng xạ, có năng lực phóng xạ
restructure: tái cấu trúc
rectangular: hình hộp chữ nhật
reclamation: sự cải thiện, khai khoang
reformation: sự sửa đổi
recombinant: tái tổ hợp
rationality: tính hợp lý
reconstruct: tái tạo lại
registered: đã đăng ký
relatively: tương đối
reasonable: hợp lý
respective: tương ứng
resolution: sự phân giải
reputation: uy tín, danh tiếng
retirement: sự nghỉ hưu
restaurant: nhà hàng
regulation: quy định, có quy tắc
revolution: cuộc cách mạng, cuộc trỗi dậy, cuộc khởi nghĩa
restricted: hạn chế
resistance: sự chống cự, sức cản
remarkable: đáng chú ý
regardless: bất kể, không để ý
republican: cộng hòa
reflection: sự chỉ trích, sự phản chiếu
repeatedly: nhiều lần, nhắc lại
recreation: giải trí, sự tái tạo
responsive: phản ứng nhanh nhẹn
roundtable: bàn tròn
reportedly: được báo cáo
redemption: sự mua chuộc, chuộc lỗi
receivable: phải thu, có biên lai
reference: tài liệu tham khảo
regarding: chú ý, để ý
represent: đại diện
reduction: giảm bớt
religious: tôn giáo
recording: ghi âm
recognize: nhìn nhận, công nhận, nhận biết
reception: tiếp nhận
remainder: phần còn lại
recession: suy thoái
realistic: thực tế, hiện thực
recommend: giới thiệu, dặn dò
radiation: sự phóng xạ
residence: nơi cư trú, chỗ ở
retention: giữ lại, sự tự chế
reluctant: lưỡng lự, miễn cưỡng
relevance: sự liên quan, sự thích đáng
redundant: dư thừa, rườm rà
research: nghiên cứu
required: cần thiết
received: nhận, có nhận
remember: nhớ
regional: khu vực
response: sự đáp lại, phản ứng
relevant: liên quan, thích hợp
resource: nguồn, phương pháp, phương sách
recovery: sự tìm lại, sự hồi phục
register: đăng ký
relative: quan hệ, tùy theo
reliable: đáng tin cậy
republic: cộng hòa, đoàn thể
reaction: phản ứng
repeated: lặp đi lặp lại
release: giải phóng, giấy biên nhận
related: liên quan, có dính dáng
running: đang chạy, liên tiếp
receive: tiếp đãi, tiếp đón, nhận được
revenue: doanh thu, tiền lời, lợi tức
remains: còn lại 
require: yêu cầu, cần dùng
reflect: phản chiếu, nghĩ ngợi, dội lại
respect: tôn trọng, kính trọng
regular: đều đặn, thường xuyên
request: yêu cầu, đòi hỏi
reality: thực thế, sự thật
respond: trả lời
report: báo cáo
result: kết quả
really: có thật không?
recent: gần đây, mới đây
record: ghi lại 
return: sự đền bù, trở về
rather: hơn, chút ít
reason: lý do, duyên cớ
reform: cải cách, canh tân
reduce: giảm
remain: còn lại, đồ ăn dư thừa
right: đúng, hoàn toàn
range: xếp hàng, phạm vi
round: tròn, xung quanh
reach: chạm tới, đưa ra
ready: sẵn sàng, chuẩn bị cho việc gì
radio: đài radio
royal: hoàng gia, lộng lẫy
rapid: nhanh, mau lẹ, ngay thẳng
raise: nâng cao, gây ra
river: con sông
route: lộ trình
refer: tham khảo
ratio: tỷ lệ
rough: thô, gập ghềnh
real: thực tế thực sự
rate: tỷ lệ, khiển trách
risk: rủi ro
road: con đường
rose: hoa hồng
rest: nghỉ ngơi
read: đọc
role: luật lệ, quy định, vai trò
ring: nhẫn
straightforward: thẳng thắn, chân thật
superconducting: siêu dẫn
semisubmersible: bán trôi chảy 
sympathomimetic: giao cảm
supernaturalism: thuyết siêu nhiên
semitransparent: bán trong suốt
subprofessional: chuyên nghiệp
supernutritions: siêu dinh dưỡng
supersaturation: bão hòa
superintendence: giám thị
specialization: chuyên môn hóa
susceptibility: sự nhạy cảm
stratification: sự phân tầng
superstructure: cấu trúc thượng tầng
sensationalism: chủ nghĩa giật gân
seroconversion: chuyển đổi huyết thanh
straightjacket: áo khoác
superscription: ghi trên đâu đó
supercontinent: siêu lục địa
sentimentalize: tình cảm hóa
sophisticated: tinh vi
semiconductor: chất bán dẫn
specification: sự chỉ rõ
socioeconomic: kinh tế xã hội
supercomputer: siêu máy tính
subcontractor: nhà thầu phụ
schoolteacher: giáo viên
semicivilized: bán văn minh
supersensible: siêu phàm, siêu cảm giác
significative: có ý nghĩa
streetwalker: người đi đường
straightedge: cạnh thẳng, góc thẳng
sectionalism: chủ nghĩa phân biệt
subcomponent: thành phần phụ
stupefaction: sự ngạc nhiên, sự sửng sốt
sensorimotor: cảm biến
subjectivism: chủ nghĩa chủ quan
schoolmaster: hiệu trưởng, thầy giáo
significant: có ý nghĩa
substantial: đáng kể, bền bỉ
shareholder: cổ đông 
statistical: thống kê
stockholder: chủ kho
sensitivity: nhạy cảm
supervision: giám đốc, sự giám thị
spectacular: cảnh sắc, đẹp mắt
scholarship: học bổng, sự thông thái
speculation: suy đoán, quan sát
supermarket: siêu thị
sympathetic: thông cảm
substantive: thực chất
streamlined: sắp xếp hợp lý
seventeenth: thứ mười bảy
spreadsheet: bảng tính
segregation: sự phân biệt
suppression: sự đàn áp, sự bãi bỏ
subdivision: sự chia nhỏ, sự chia ra
synthesized: tổng hợp
successful: thành công
subsidiary: công ty con
scientific: thuộc về khoa học
sufficient: đủ, đầy đủ
subsequent: tiếp theo
settlement: giải quyết
structural: cấu trúc
specialist: chuyên gia, nhà chuyên môn
statistics: sự thống kê, số liệu thống kê
strengthen: củng cố
supplement: phần bổ sung
suggestion: gợi ý
submission: nộp hồ sơ
succession: sự kế thừa
supportive: ủng hộ
sympathize: thông cảm
something: một thứ gì đó, cái gì đó
statement: tuyên bố
strategic: chiến lược
situation: tình hình
sometimes: đôi khi
secretary: thư ký
selection: sự lựa chọn
secondary: thứ hai
sensitive: nhạy cảm
somewhere: một vài nơi
satisfied: hài lòng
substance: vị trí
software: phần mềm
standard: tiêu chuẩn
security: bảo vệ
solution: giải quyết
strategy: chiến lược
strength: sức mạnh
superior: cấp trên
surprise: ngạc nhiên
service: dịch vụ
support: hỗ trợ
several: một vài
subject: môn học
special: đặc biệt
similar: giống nhau
section: phần
success: sự thành công
society: xã hội
someone: người nào đó
science: khoa học
serious: nghiêm trọng
student: sinh viên
setting: cài đặt
should: nên
system: hệ thống
second: thứ hai
school: trường học
strong: khỏe khoắn
single: độc thân
social: xã hội
series: loạt
street: đường phố
source: nguồn
simply: đơn giản
senior: cao cấp
supply: cung cấp
simple: đơn giản
season: mùa
safety: an toàn
summer: mùa hè
still: vẫn
state: tiểu bang
since: từ
small: nhỏ
staff: nhân viên
share: chia sẻ
short: ngắn
south: miền nam
start: bắt đầu
stock: cổ phần
study: học tập
seven: số bảy
story: câu chuyện
sense: giác quan
space: không gian
stage: sân khấu
speed: tốc độ
sound: âm thanh
serve: cư xử
said: nói
some: một vài
such: như là
show: cho xem
site: địa điểm
sure: chắc chắn, bảo đảm
sale: bán
soon: sớm
stop: dừng lại
stay: ở lại
seem: dường như
send: gửi
sign: ký tên
star: ngôi sao
see: thấy
six: số sáu
son: đứa con
sea: biển
sun: mặt trời
transfiguration: sự biến hình
transhistorical: xuyên lịch sử
transferability: khả năng chuyển nhượng
transportations: vận chuyển
transpositional: chuyển tiếp
trustworthiness: đáng tin cậy
territorialized: lãnh thổ
temperatenesses: ôn hòa
temporarinesses: tạm thời
therapeutically: trị liệu
telephotography: chụp ảnh từ xa
transportation: vận chuyển
transformation: sự biến đổi
teleconference: hội nghị từ xa
transcendental: siêu việt
traditionalism: chủ nghĩa truyền thống
telangiectasia: giãn tĩnh mạch xa
transmissivity: sự truyền
territorialism: chủ nghĩa lãnh thổ
teletypewriter: máy đánh chữ
traditionalize: truyền thống hóa
technological: công nghệ
transcription: phiên mã
transnational: xuyên quốc gia
telemarketing: tiếp thị qua điện thoại
transatlantic: xuyên Đại Tây Dương
thermoplastic: nhựa nhiệt dẻo
transgression: sự vi phạm
transgendered: chuyển giới
thermonuclear: nhiệt hạnh
triangulation: tam giác
thoroughgoing: kỹ lưỡng
transmission: quá trình lây truyền
transparency: minh bạch
thanksgiving: tạ ơn
troubleshoot: khắc phục sự cố
tranquillity: yên bình
thoroughfare: lộ trình
transduction: chuyển nạp
technicality: tính kỹ thuật
thunderstorm: giông
transfection: chuyển giao
thermocouple: cặp nhiệt điện
thermography: nhiệt kế
traditional: truyền thông
transaction: giao dịch
temperature: nhiệt độ
translation: dịch
theoretical: lý thuyết
therapeutic: trị liệu
terminology: thuật ngữ
transparent: trong suốt
termination: chấm dứt
theological: thần học
territorial: lãnh thổ
terrestrial: trên cạn
temperament: tính cách
transmitter: hệ thống điều khiển
troublesome: khó khăn
treacherous: bội bạc
translucent: mờ
transfusion: truyền máu
transdermal: thẩm thấu qua da
transformer: máy biến áp
technology: công nghệ
throughout: khắp
themselves: chúng tôi
tremendous: to lớn
transition: chuyển tiếp
television: TV
threatened: bị đe dọa
tournament: giải đấu
thereafter: sau đó
temptation: sự cám dỗ
thoughtful: chu đáo
theatrical: thuộc sân khấu
throughput: thông lượng
turnaround: quay lại
transplant: cấy
transcript: bảng điểm
technician: kỹ thuật viên
transistor: bóng dán dẫn
turbulence: nhiễu loạn
triumphant: đắc thắng
tomography: chụp cắt lớp
translator: người dịch
triangular: hình tam giác
topography: địa hình
therefore: vì thế
technical: kỹ thuật
treatment: sự đối xử
transport: vận chuyển
tradition: truyền thống
telephone: điện thoại
temporary: tạm thời
technique: kỹ thuật
territory: lãnh thổ
terrorist: khủng bố
trademark: nhãn hiệu
transform: biến đổi
testament: di chúc
treasurer: thủ quxy
threshold: ngưỡng
together: cùng nhau
training: đào tạo
thinking: suy nghĩ
transfer: chuyển khoản
thousand: nghìn
teaching: giảng bài
terminal: thiết bị đầu cuối
treasury: kho bạc
tomorrow: ngày mai
terrible: kinh khủng
turnover: doanh số
tendency: khuynh hướng
tracking: theo dõi
taxation: thuế
thirteen: mười ba
thorough: kỹ lưỡng
traveled: đi du lịch
tailored: phù hợp
tropical: nhiệt đới
talisman: bùa hộ mệnh
typology: phân loại học
through: xuyên qua
thought: nghĩ
towards: hướng tới
traffic: giao thông
trouble: rắc rối
teacher: giáo viên
tonight: tối nay
typical: điển hình
turning: quay
telling: nói
totally: tổng cộng
thereby: bằng cách ấy
telecom: viễn thông
therapy: trị liệu
theatre: rạp hát
tension: căng thẳng
tragedy: bi kịch
tourism: du lịch
tribute: cống vật
tactics: chiến thuật
tobacco: thuốc lá
transit: quá cảnh
tourist: khách du lịch
triumph: chiến thắng
though: tuy nhiên
taking: đang lấy
trying: cố gắng
travel: du lịch
twenty: hai mươi
target: mục tiêu
theory: học thuyết
twelve: mười hai
thirty: ba mươi
toward: về phía
threat: mối đe dọa
thanks: cảm ơn
timing: thời gian
talent: năng lực
taught: đã dạy
tissue: mô
ticket: vé
tenant: người thuê nhà
tennis: quần vợt
timely: hợp thời
tender: đấu thầu
treaty: hiệp ước
their: của chúng
today: hôm nay
three: số ba
total: toàn bộ
taken: lấy
trade: buôn bán
times: lần
table: bàn
trust: lòng tin
thing: điều
track: theo dõi
title: tiêu đề
train: xe lửa
trend: khuynh hướng
tower: tòa tháp
truth: sự thật
treat: đãi
theme: chủ đề
teach: dạy
taste: nếm thử
they: bọn họ
time: thời gian
then: sau đó
them: chúng
than: hơn
take: lấy
team: đội
told: kể lại
term: kỳ hạn
took: lấy
turn: xoay
type: kiểu
true: sự thật
thus: do đó
test: kiểm tra
tell: nói
talk: nói chuyện
town: thị trấn
text: bản văn
underprivileged: kém cỏi
unsubstantiated: không có căn cứ
unsophisticated: không phức tạp
uncontroversial: không đối nghịch
undistinguished: không phân biệt
ultrasonography: siêu âm
unsportsmanlike: phi thể thao
ultrafiltration: siêu lọc
unprepossessing: không chuẩn bị
unchallengeable: không thể thách thức
unpronounceable: không thể phát âm
unobjectionable: không thể chối cãi
uncommunicative: không thông thạo
unexceptionable: không thể chấp nhận được
undemonstrative: không bắt buộc
unpronounceable: không thể phát âm
unparliamentary: không có nghị viện
ultracentrifuge: siêu ly âm
unaccommodating: không thoải mái
uncompromisable: không khoan nhượng
ultramicroscope: kính hiển vi siêu nhỏ
unexceptionably: không thể chấp nhận được
unsettlednesses: bất ổn
understandable: có thể hiểu được
unsatisfactory: không đạt yêu cầu
uncompromising: không khoan nhượng
understatement: sự nói nhỏ
uncontrollable: không kiểm soát được
unconventional: khác thường
underdeveloped: kém phát triển
unintelligible: khó hiểu
unidirectional: một chiều
unquestionable: không thể nghi ngờ
undersecretary: dưới thư ký
unidentifiable: không xác định được
universalistic: phổ quát
ultrastructure: siêu cấu trúc
unconscionable: vô lương tâm
utilitarianism: thuyết vị lợi
uncontaminated: không bị ô nhiễm
unappreciative: không tán thưởng
undernutrition: thiếu dinh dưỡng
underpopulated: dân số ít
ultraminiature: siêu nhỏ
undomesticated: không có tinh vi
unchivalrously: phi thường
understanding: hiểu hết
unprecedented: chưa từng có
uncomfortable: khó chịu
unanticipated: không lường trước
unpredictable: không thể đoán trước
uninterrupted: không bị gián đoạn
underestimate: đánh giá quá thấp
unconditional: vô điều kiện
unintentional: không cố ý
uncomplicated: không phức tạp
unforgettable: không thể nào quên
unsustainable: không bền vững
unenforceable: không thể thi hành
unconceivable: không thể tưởng tượng được
undissociated: không phân ly
unconformable: không phù hợp
uncalculating: không tính toán
unsusceptible: không thể nhận ra
unemployment: thất nghiệp
unacceptable: không thể chấp nhận được
unsuccessful: không thành công
unparalleled: vô song
unreasonable: không hợp lý
unrestricted: không hạn chế
unbelievable: không thể tin được
unauthorized: không được phép
unidentified: không xác định
unregistered: chưa đăng ký
unprofitable: không có lợi
unmistakable: không thể nhầm lẫn
uncontrolled: không kiểm soát được
unstructured: không có cấu trúc
unattractive: không hấp dẫn
underpinning: nền tảng
unsuspecting: không nghi ngờ
unproductive: không hiệu quả
unobservable: không thể quan sát được
unreflective: không hoạt động
unacquainted: không quen biết
unreconciled: không được ghi lại
unrepeatable: không thể lặp lại
unassociated: không liên kết
underclothes: quần áo lót
unpardonable: không thể tha thứ
unlikelihood: không có khả năng
unresolvable: không thể giải quyết
unpublicized: không công bố
uninfluenced: không có rào cản
underlayment: lớp lót
unprejudiced: không thành kiến
unverifiable: không thể kiểm chứng
uncertainty: tính không chắc chắn
underground: dưới lòng đất
unnecessary: không cần thiết
undertaking: đảm nhận
unfortunate: thật không may
unfavorable: không thuận lợi
unconscious: bất tỉnh
unavailable: không có sẵn
unrealistic: không thực tế
unpublished: chưa xuất bản
undisclosed: không tiết lộ
undesirable: không mong muốn
unavoidable: không thể tránh khỏi
unspecified: không xác định
ultraviolet: tia cực tím
undeveloped: chưa phát triển
unthinkable: không thể tưởng tượng được
unqualified: không đủ tiêu chuẩn
underwriter: người bảo lãnh
unsolicited: không được yêu cầu
unexplained: không giải thích được
unsurpassed: vượt trội
unimportant: không quan trọng
unambiguous: rõ ràng
unprotected: không được bảo vệ
unregulated: không được kiểm soát
unequivocal: rõ ràng
understated: nói nhỏ
unwarranted: không chính đáng
utilitarian: thực dụng
unrelenting: không ngừng
undisturbed: không bị xáo trộn
unjustified: phi lý
unorganized: không có tổ chức
unpatriotic: không yêu nước
undisguised: không ngụy trang
unsweetened: không đường
uncorrected: chưa sửa
unglamorous: không hài hước
unemotional: bất định
unbeknownst: không biết
unflappable: không thể áp dụng
unvarnished: chưa trang bị
unrewarding: không chuyển tiếp
undersigned: ký tên dưới
unconverted: không được chuyển đổi
unmotivated: không có động cơ
unaddressed: không mặc quần áo
ultrasonics: siêu âm
unhealthful: không có lợi
uninsurable: không thể sửa được
university: trường đại học
understand: hiểu biết
ultimately: cuối cùng
underlying: cơ bản
understood: hiểu
unexpected: bất ngờ
unemployed: thất nghiệp
underneath: bên dưới
unfamiliar: không quen
unpleasant: khó chịu
ubiquitous: phổ cập
unforeseen: không lường trước được
unaffected: không bị ảnh hưởng
unofficial: không chính thức
underwater: dưới nước
unreliable: không đáng tin cậy
ultrasound: siêu âm
unresolved: chưa được giải quyết
unfinished: chưa xong
unilateral: đơn phương
unsuitable: không hợp
upbringing: nuôi dưỡng
unanswered: không được trả lời
undercover: bí mật
universal: phổ cập
undertake: đảm nhận
uncertain: không chắc chắn
unchanged: không thay đổi
unlimited: vô hạn
unwilling: không muốn
unrivaled: vô song
unrelated: không liên quan
undermine: hủy hoại
underwent: đã trải qua
uncovered: không che đậy
unsecured: không đảm bảo
unanimous: nhất trí
undertook: đã đảm nhận
unaudited: chưa được kiểm toán
unmatched: vô đối
unpopular: không phổ biến
underwear: đồ lót
unnoticed: không được chú ý
untouched: không đụng chạm
unmarried: chưa kết hôn
untreated: chưa được điều trị
unhealthy: không khỏe mạnh
unnatural: không tự nhiên
unwelcome: không được hoan nghênh
unskilled: không có kỹ năng
unplanned: ngoài kế hoạch
unbounded: không bị ràng buộc
unfailing: không ngừng
uninjured: không bị thương 
underlain: nền tảng
unreality: không thực tế
unhurried: không vội vã
unadorned: không trang trí
unelected: không được chọn
unknowing: không biết
unearthly: rõ ràng
uppercase: chữ hoa
untainted: không sơn
undesired: không mong muốn
unexpired: chưa hết hạn
unrefined: không tinh chế
unceasing: không ngừng
unfeeling: không cảm thấy
undertone: tông màu
ultrahigh: cực cao
underhand: ám chỉ
unashamed: không xấu hổ
unruffled: không gợn sóng
untypical: không điển hình
undergrad: đại học
underbody: gầm
underpass: đường chui
unlikely: không chắc
ultimate: tối thượng
universe: vũ trụ
unlawful: trái pháp luật
umbrella: ô
upstairs: tầng trên
unwanted: không mong muốn
upcoming: sắp tới
uncommon: không phổ biến
unstable: không ổn định
upstream: thượng nguồn
unbeaten: bất bại
unbiased: không thiên vị
unbilled: chưa thanh toán
upheaval: biến động
untapped: chưa được khai thác
uprising: cuộc nổi dậy
unearned: chưa được khai phá
unspoken: không nói ra
underlie: chưa được khai phá
undercut: không nói ra
underpin: nền tảng
unproven: chưa được xác minh
unbroken: không bị gián đoạn
uncoated: không tráng
unleaded: không chì
unmarked: không được đánh dấu
unmanned: không người lái
untested: chưa được kiểm tra
unwieldy: khó di chuyển
unknown: không xác định
unusual: bất thường
utility: tiện ích
uniform: đồng phục
upgrade: nâng cấp
upscale: cao cấp
unhappy: không vui
unclear: không rõ
unaware: không biết
utilize: sử dụng
undergo: trải qua
urgency: khẩn cấp
utterly: hoàn toàn
useless: vô ích
upright: ngay thẳng
uncover: khám phá ra
unequal: không bằng nhau
unnamed: vô danh
unitary: nhất thể
unheard: không nghe
uncanny: kỳ lạ
unlucky: không may
utopian: không tưởng
unleash: giải phóng
unravel: làm sáng tỏ
upsurge: thăng trầm
unrated: chưa được xếp hạng
unarmed: không có vũ khí
uptrend: xu hướng tăng
undoing: hoàn tác
upswing: nâng lên
united: thống nhất
unique: độc nhất
unless: trừ khi
useful: hữu ích
unable: không thể
update: cập nhật
unlike: không giống
urgent: khẩn cấp
unfair: không công bằng
upward: hướng lên
uptime: thời gian hoạt động
unpaid: chưa thanh toán
upload: tải lên
unused: không sử dụng
upheld: đề cao
unrest: bất ổn
uneven: không đồng đều
unlock: mở khóa
unsure: không chắc chắn
utmost: hết sức
uneasy: khó chịu
usable: dùng được
unsafe: không an toàn
unseen: không nhìn thấy
uptake: hấp thu
uphold: đề cao
unduly: quá mức
uphill: lên dốc
untrue: không có thật
unveil: tiết lộ
unjust: oan gia
uplink: đường lên
undead: xác sống
unwrap: mở ra
unmade: chưa làm
undies: áo lót
unmask: vạch mặt
uncool: cởi trần
unfree: không tự do
unclog: mở ra
unroll: bỏ cuộn
unmold: không bán
upsize: tăng kích thước
unripe: chưa chín
unmake: chưa may
ureter: niệu quản
uncork: tháo khóa
unhook: tháo ra
under: dưới
until: cho đến khi
union: liên hiệp
urban: thành thị
upper: phía trên
usual: bình thường
usage: sử dụng
upset: buồn bã
unity: thống nhất
undue: thái quá
uncle: chú
ultra: cực kỳ
urine: nước tiểu
unite: đoàn kết
utter: thốt ra
unmet: chưa được đáp ứng
usher: mở ra
unify: thống nhất
unfit: không thích hợp
uncut: chưa cắt
usurp: chiếm đoạt
unlit: không có đèn
used: đã sử dụng 
upon: trên
unit: đơn vị
user: người dùng
urge: thúc giục
ugly: xấu xí
undo: hoàn tác
unto: đến
videoconference: cầu truyền hình
vascularization: mạch máu
viscoelasticity: tính nhớt dẻo
vasoconstrictor: thuốc co mạch
vasodilatations: giãn mạch
valuelessnesses: vô giá trị
valetudinarians: người hầu
vicissitudinous: thăng trầm
vicariousnesses: nạn nhân
vexatiousnesses: khó chịu
versatilenesses: tính linh hoạt
veraciousnesses: ý thức
verifiabilities: xác minh trách nhiệm pháp lý
veritablenesses: thực sự
ventriloquially: nói tiếng bụng
venturesomeness: tính mạo hiểm 
venerablenesses: đáng kính
visionarinesses: tầm nhìn xa trông rộng
vivaciousnesses: hoạt bát
vivisectionists: những người theo chủ nghĩa tưởng tượng
volatilizations: bay hơi
voicelessnesses: vô thanh
voraciousnesses: phàm ăn
voluntarinesses: sự tự nguyện
vulnerabilities: lỗ hổng bảo mật
voyeuristically: mãn nhãn
volatilization: bay hơi
volatilenesses: tính dễ bay hơi
voicefulnesses: giọng nói
voidablenesses: tính vô hiệu
volcanologists: các nhà núi lửa học
volcanological: núi lửa
voluminosities: khối lượng
volumetrically: về mặt thể tích
voluminousness: đồ sộ
voluptuousness: sự gợi cảm
vouchsafements: bảo đảm
vocationalisms: dạy nghề
valetudinarian: người hầu
valedictorians: thủ khoa
valuablenesses: giá trị
vaporishnesses: sự bốc hơi
variablenesses: sự thay đổi
vandalizations: phá hoại
vasodilatation: giãn mạch
vasoactivities: hoạt động mạch
verifiableness: khả năng xác minh
veridicalities: những thói quen 
vermiculations: chế phẩm sinh học
verbalizations: lời nói
verticalnesses: độ thẳng đứng
versifications: sự thay đổi
vesicularities: mụn nước
vegetativeness: sinh dưỡng
vegetarianisms: người ăn chay
ventriloquists: người nói tiếng bụng
ventriloquized: nói tiếng bụng
valedictorian: thủ khoa
vegetarianism: ăn chay
vocationalism: chủ nghĩa nghề nghiệp
ventrolateral: bên bụng
vermiculation: vi khuẩn
verbigeration: xung quanh
verbosenesses: độ dài
verbalization: lời nói
veraciousness: ý thức
veritableness: tính chân mật
verisimilarly: tương tự
verifiability: khả năng xinh minh
verifications: xác minh
verticalities: dọc
vertiginously: dài dòng
versification: sự linh hoạt
versatilities: sự tương đồng
versatileness: tính linh hoạt
vesiculations: mụn nước
venturesomely: mạo hiểm
venturousness: tính mạo hiểm
vociferations: tiếng nói
vocalizations: giọng nói
voluntariness: sự tự nguyện
volunteerisms: tình nguyện
voluntaristic: tự nguyện
voluntaryists: những người tự nguyện
voluntaryisms: sự tự nguyện
voraciousness: phàm ăn
vouchsafement: xác nhận
volcanologies: núi lửa
volcanologist: nhà núi lửa học
volublenesses: độ hòa tan
voicelessness: vô thanh
volatilizable: dễ bay hơi
volcanicities: núi lửa
virologically: về mặt virus
verification: xác minh
volunteerism: tình nguyện
veterinarian: bác sĩ thú y
venipuncture: chích tĩnh mạch
vainglorious: hay khoe khoang
vasodilation: giãn mạch
vituperation: chửi rủa
velociraptor: vận tốc
ventromedial: não thất
vacationland: kỳ nghỉ
voluntaryism: chủ nghĩa tự nguyện
viscosimeter: máy đo độ nhớt
verticillate: dọc
valetudinary: người hầu
vaticination: sự say mê
viruliferous: còn trinh
visitatorial: thăm khám bệnh
vitalization: sự sống lại
virtuousness: đức hạnh
virtuosities: kỹ thuật điêu luyện
viscometries: nhớt kế
variability: sự  thay đổi
ventilation: thông gió
vaccination: tiêm chủng
ventricular: tâm thất
vindication: sự minh oan
vinaigrette: giấm
videography: quay phim
vertiginous: chóng mặt
vasculature: mạch máu
voluntarism: tình nguyện
vasodilator: thuốc giãn mạch
viticulture: nghề trồng nho
valedictory: thủ khoa
vivisection: hình dung
venturesome: thích mạo hiểm
victimology: nạn nhân
valediction: định giá
viscountess: nữ tử tước
viceroyalty: lòng trung thành
vulnerable: dễ bị tổn thương
visibility: hiển thị
vocabulary: từ vựng
vocational: nghề
veterinary: thú y
vegetation: thảm thực vật
vegetarian: ăn chay
volleyball: bóng chuyền
vernacular: tiếng địa phương
victorious: chiến thắng
viewership: lượng người xem
verifiable: có thể kiểm chứng
visitation: thăm viếng
voluminous: đồ sộ
ventilator: máy thở
vertebrate: động vật có xương sống
vociferous: to tiếng
vindictive: thù hằn
virtuosity: kỹ thuật điêu luyện
vaudeville: tạp kỹ
variegated: loang lổ
vestibular: tiền đình
viewfinder: kính ngắm
vegetative: thực vật
veneration: sự tôn kính
volumetric: thể tích
villainous: phản diện
videophone: cuộc gọi video
viscometer: máy đo độ nhớt
visualizer: trình hiển thị
vasoactive: hoạt huyết
vasculitis: viêm mạch
victimless: nạn nhân
voiceprint: giọng nói
vermicelli: bún tàu
villainess: tính xấu xa
volatilize: bay hơi
vitrectomy: cắt dịch kính 
vibraphone: rung
virtually: hầu như
voluntary: tình nguyện
variation: biến thể
valuation: định giá
volunteer: tình nguyện viên
versatile: linh hoạt
violation: sự vi phạm
viewpoint: quan điểm
vegetable: rau
visionary: nhìn xa trông rộng
vibration: rung động
valentine: lễ tình nhân
vandalism: sự phá hoại
vengeance: sự báo thù
visualize: hình dung
venerable: đáng kính
viscosity: độ nhớt
videotape: băng video
vigilance: cảnh giác
veritable: thực sự
vehicular: xe cộ
virginity: trinh tiết
voracious: tham ăn 
vicarious: tương đối
vulgarity: thô tục
vermilion: màu đỏ son
vigilante: người cảnh giác
vivacious: hoạt bát
vindicate: minh oan
vertebral: đốt sống
voiceless: vô thanh
vestibule: tiền đình
ventricle: tâm thất
valuable: quý giá
violence: bạo lực
variable: biến đổi
vertical: theo chiều dọc
volatile: bay hơi
velocity: vận tốc
vacation: kỳ nghỉ
vigorous: mạnh mẽ
variance: phương sai
vascular: mạch máu
vitality: sức sống
vicinity: lân cận
volcanic: núi lửa
validate: xác nhận
vanguard: đội tiên phong
vineyard: vườn nho
vigilant: cảnh giác
vocation: công việc
virtuous: đức hạnh
verbatim: nguyên văn
vocalist: giọng ca
visceral: nội tạng
virulent: độc hại
virtuoso: điêu luyện
vaulting: kho tiền
vignette: họa tiết
varietal: giống nhau
various: đa dạng
variety: đa dạng
version: phiên bản
village: làng
venture: liên doanh
victory: chiến thắng
vehicle: phương tiện
visible: có thể nhìn thấy
virtual: ảo
veteran: cựu chiến binh
viewing: đang xem
violent: hung bạo
visitor: khách thăm quan
voltage: vôn
verdict: phán quyết
vintage: cổ điển
vitamin: vitamin
vibrant: sôi động
vicious: luẩn quẩn
vaccine: vắc xin
vacancy: vị trí tuyển dụng
variant: biến thể
violate: xâm phạm
vantage: thuận lợi
voucher: chứng từ
vinegar: giấm
villain: nhân vật phản diện
volcano: núi lửa
valley: thung lũng
volume: âm lượng
vision: tầm nhìn
visual: trực quan
vendor: người bán hàng
versus: đấu với
victim: nạn nhân
varied: đa dạng
virgin: trinh nữ
viable: khả thi
virtue: đức hạnh
victor: người chiến thắng
vessel: tàu
verbal: bằng lời nói
vacuum: máy hút bụi
vacant: bỏ trống
viewer: người xem
verify: kiểm chứng
vested: được trao
voiced: lồng tiếng
velvet: nhung
voyage: hành trình
vanity: tự phụ
violin: đàn vi ô lông
violet: màu tím
vulgar: thô tục
venous: tĩnh mạch
vanish: tan biến
veiled: che kín mặt
verity: chân thật
veneer: ván lạng
vortex: xoáy nước
versed: thành thạo
volley: chuyền
vigour: sức sống
vapour: hơi nước
voodoo: thư
visit: chuyến thăm
value: giá trị
voice: tiếng nói
video: video
vital: quan trọng
valid: có hiệu lực
virus: vi rút
venue: hội họp
villa: biệt thự
vague: mơ hồ
vivid: sống động
vocal: giọng hát
valve: van
verse: thơ
viral: lan tỏa
vapor: hơi
verge: bờ vực
voter: cử tri
vinyl: nhựa
vault: kho tiền
vogue: thịnh hành
vigor: sức sống
vodka: rượu vodka
vigil: cảnh giác
vying: tranh giành
venom: nọc độc
valet: người hầu
very: rất
view: lượt xem
vice: hành vi xấu xa
vote: bỏ phiếu
vast: rộng lớn
vary: khác nhau
void: vô hiệu
vein: tĩnh mạch
visa: hộ chiếu
veto: phủ quyết
vine: cây nho
verb: động từ
vest: áo vest
veil: mạng che mặt
vain: vô ích
vent: lỗ thông hơi
volt: vôn
vase: cái bình hoa
vile: hèn hạ
vibe: rung cảm
veal: thịt bê
vial: lọ
vail: thùng
vane: cánh gạt
veer: xoay quanh
weatherboarding: lướt ván
wearisomenesses: mệt mỏi
weatherproofing: thời tiết
weatherizations: phong hóa
westernisations: phương Tây hóa
warmheartedness: lòng nhân hậu
worthlessnesses: những điều vô giá trị
wonderfulnesses: sự tuyệt vời
wheelbarrowing: xe cút kít
whimsicalities: hay thay đổi
whortleberries: quả việt quất
wholeheartedly: hết lòng
winglessnesses: không có cánh
wordlessnesses: không lời
workablenesses: tính khả thi
worklessnesses: thất nghiệp
womanishnesses: phụ nữ
wondrousnesses: sự kỳ diệu
worthwhileness: đáng giá
worshipfulness: sự tôn thờ
watercolorists: màu nước
watchfulnesses: cảnh giác
whithersoever: tuy nhiên
whitewashings: tẩy trắng
whipstitching: roi da
whimsicalness: hay thay đổi
wheelbarrowed: xe cút kít
wholesomeness: tính lành mạnh
winsomenesses: những lợi ích
willfulnesses: ý chí
willingnesses: sự sẵn lòng
wimpishnesses: tính xấu
winterberries: quả việt quất
winterization: đồng hóa
winterfeeding: cho ăn đông
wishfulnesses: mơ ước
withdrawnness: sự rút lui
witlessnesses: sự khôn ngoan
wistfulnesses: bâng khuâng
wonderfulness: sự tuyệt vời
welterweight: trọng lượng hàn
wholehearted: hết lòng
weatherproof: thời tiết
warehouseman: nhân viên kho hàng
workingwoman: phụ nữ làm việc
whimsicality: tính hay thay đổi
waterfowling: chim nước
weatherglass: kính thời tiết
weatherboard: bảng thời tiết
wherethrough: qua
whortleberry: cây nham lê
withoutdoors: không có ngoài trời
weightlessly: không trọng lượng
weathercasts: dự báo thời tiết
weathercocks: thời tiết
weatherizing: phong hóa
workstation: máy trạm
withholding: khấu trừ
whereabouts: nơi ở
workmanship: tay nghề
woodworking: chế biến gỗ
windsurfing: lướt ván
wheelbarrow: xe cút kít
waterlogged: úng nước
workmanlike: công nhân
westernmost: cực Tây
wastebasket: thùng rác
wheelwright: thợ làm bánh xe
wintergreen: mùa đông xanh
wearability: khả năng mặc
waitressing: hầu bàn
widespread: phổ biến rộng rãi
withdrawal: rút tiền
worthwhile: đáng giá
wastewater: nước thải
whatsoever: bất cứ điều gì
wilderness: hoang vu
wheelchair: xe lăn
wavelength: bước sóng
waterfront: bờ sông
waterproof: không thấm nước
watercraft: tàu thủy
weathering: phong hóa
watercolor: màu nước
witchcraft: phù thủy
wonderland: xứ sở thần tiên
windscreen: kính ô tô
windshield: kính chắn gió
waterworks: công trình nước
watertight: kín nước
workaholic: tham công tiếc việc
woodpecker: chim gõ kiến
wristwatch: đồng hồ đeo tay
watercress: cải xoong
worldwide: trên toàn thế giới
wonderful: tuyệt vời
wholesale: bán sỉ
warehouse: kho
wondering: tự hỏi
workplace: nơi làm việc
withdrawn: rút lại
withstand: chịu được
whichever: nào
wrestling: đấu vật
webmaster: quản vị viên web
wallpaper: hình nền
watershed: đầu nguồn
worthless: vô giá trị
weathered: phong hóa
waterfall: thác nước
wholesome: lành mạnh
whirlpool: xoáy nước
whitehead: tóc trắng
whirlwind: gió lốc
workbench: bàn làm việc
whimsical: hay thay đổi
whereupon: từ đó
wasteland: đất hoang
whatever: bất cứ điều gì
wireless: không dây
whenever: bất cứ điều gì
weighted: có trọng lượng
wherever: bất cứ nơi nào
weakness: yếu đuối
workshop: xưởng
woodland: rừng cây
wildlife: động vậy hoang dã
withdraw: rúi lui
warranty: sự bảo đảm
workload: khối lượng công việc
workflow: quy trình làm việc
wardrobe: tủ quần áo
wrapping: gói
watchdog: người canh gác
workable: khả thi
wreckage: đống đổ nát
without: không có
working: đang làm việc
website: trang mạng
whether: liệu
written: bằng văn bản
western: miền Tây
winning: chiến thắng
writing; viết
waiting: đang chờ đợi
welcome: chào mừng
weather: thời tiết
weekend: ngày cuối tuần
willing: sẵn lòng
walking: đi dạo
whereas: trong khí
within: trong
writer: nhà văn
weight: cân nặng
window: cửa sổ
wholly: hoàn toàn
winter: mùa đông
wealth: sự giàu có
winner: người chiến thắng
wonder: ngạc nhiên
weekly: hàng tuần
worker: công nhân
walker: người đi bộ
wright: vặn vẹo
wooden: bằng gỗ
weapon: vũ khí
wisdom: sự khôn ngoan
worthy: xứng đáng
whilst: trong khi
which: cái nào
would: sẽ
where: ở đâu
world: thế giới
while: trong khi
women: đàn bà
water: nước
whole: toàn bộ
whose: ai
white: trắng 
woman: đàn bà
worth: đáng giá
write: viết
wrong: sai lầm
watch: đồng hồ đeo tay
wrote: đã viết
with: với
were: là
will: sẽ
what: cái gì
when: khi nào
well: tốt
work: công việc
want: muốn
week: tuần
went: đã đi
wider: rộng
west: cách
wire: dây điện
ways: cách
word: từ ngữ
wall: tường
wife: người vợ
whom: ai
was: đã
who: ai
way: đường
why: tại sao
war: chiến tranh
won: đã thắng
win: chiến thắng
web: website
wet: ướt
wit: mưu mẹo
wee: một chút
wax: sáp
wow: wow
wed: thứ tư
wis: khôn ngoan
woo: gâu gâu
wry: nhăn nhó
youthfulnesses: sự trẻ trung
yellowhammers: chim săn vàng
yellowthroats: màu vàng
yesternights: những đêm qua
youthfulness: sự trẻ trung
youngberries: quả non, quả xanh
youngnesses: tuổi trẻ
yellowtails: màu vàng
yellowwoods: gỗ vàng
yellowwares: đồ vàng
yardmasters: người quản lý sân bãi 
yourselves: bản thân các bạn
yesteryear: năm qua
yellowtail: đuôi vàng
yellowwood: gỗ màu vàng
yardmaster: chủ sân
youngberry: dâu non
yellowware: đồ vàng
yellowlegs: chân vàng
yellowfins: sợi vàng
yeastiness: sự tinh thần
yesterdays: những ngày qua
yeomanries: nấm men
yearningly: khao khát
yardsticks: thước đo
younglings: con non
youngsters: thanh niên
youthquake: tuổi trẻ
yellowing: ố vàng
yellowest: màu vàng nhất
yearnings: khao khát
yeastless: không men
yeastlike: giống như men
yeastiest: đẹp nhất
yearlings: năm con
yearbooks: kỷ yếu
yachtsmen: du thuyền
yachtings: du thuyền
yabbering: tiếng kêu
yardworks: sân bãi
yardbirds: chim sân
yardlands: sân đất
yappingly: ngáp
yawmeters: ngáp
yawningly: ngáp
yuckiness: kinh ngạc
yourself: bản thân bạn
yielding: năng suất
youthful: trẻ trung
yearning: khao khát
yearlong: kéo dài
yearbook: niên giám
yearling: khao khát
youngish: trẻ trung
yeomanry: phong thủy
yardbird: chim sơn ca
yeanling: dê con
yardman: người làm sân
yucking: hét lên
yogurt: sữa chua
yeasty: khoa trương
yenned: yên tâm
yeuked: yêu thích
young: trẻ
youth: thiếu niên
yield: năng suất
yours: của bạn
yacht: thuyền buồm
yeast: men
yearn: khao khát
yummy: ngon ngon
yikes: yểu điệu
yawls: ngáp
yawns: ngáp
yarns: sợi
your: của bạn
year: năm
yeah: vâng
yard: sân
yarn: sợi
yuan: nhân dân tệ
yang: dương
yoga: yoga
yell: la lên
yoke: ách
yawn: ngáp
yolk: lòng đỏ
yank: giật mạnh
yuck: kinh quá
yelp: kêu lên
you: bạn
yet: chưa
yes: vâng
